campaign_group_member_criteria_originating_subcultures_tables
0
unknown0	unknown1
diplomacy_CultureGroup_Rogue_GRN_Faction_Beastcatchas	wh2_main_rogue_beastcatchas
diplomacy_CultureGroup_Rogue_GRN_Faction_Beastcatchas_&_Negative	wh2_main_rogue_beastcatchas
diplomacy_CultureGroup_Rogue_GRN_Faction_Beastcatchas_&_Positive	wh2_main_rogue_beastcatchas
diplomacy_CultureGroup_Rogue_GRN_Faction_BlackSpiderTribe	wh2_main_rogue_black_spider_tribe
diplomacy_CultureGroup_Rogue_GRN_Faction_BlackSpiderTribe_&_Negative	wh2_main_rogue_black_spider_tribe
diplomacy_CultureGroup_Rogue_GRN_Faction_BlackSpiderTribe_&_Positive	wh2_main_rogue_black_spider_tribe
diplomacy_CultureGroup_Rogue_GRN_Faction_MangyHoundz	wh2_main_rogue_mangy_houndz
diplomacy_CultureGroup_Rogue_GRN_Faction_MangyHoundz_&_Negative	wh2_main_rogue_mangy_houndz
diplomacy_CultureGroup_Rogue_GRN_Faction_MangyHoundz_&_Positive	wh2_main_rogue_mangy_houndz
diplomacy_CultureGroup_Rogue_GRN_Faction_StuffSnatchers	wh2_main_rogue_stuff_snatchers
diplomacy_CultureGroup_Rogue_GRN_Faction_StuffSnatchers_&_Negative	wh2_main_rogue_stuff_snatchers
diplomacy_CultureGroup_Rogue_GRN_Faction_StuffSnatchers_&_Positive	wh2_main_rogue_stuff_snatchers
diplomacy_CultureGroup_Rogue_GRN_Faction_TeefSnatchaz	wh2_main_rogue_teef_snatchaz
diplomacy_CultureGroup_Rogue_GRN_Faction_TeefSnatchaz_&_Negative	wh2_main_rogue_teef_snatchaz
diplomacy_CultureGroup_Rogue_GRN_Faction_TeefSnatchaz_&_Positive	wh2_main_rogue_teef_snatchaz
diplomacy_CultureGroup_Rogue_WEF_Faction_WorldrootRangers	wh2_main_rogue_worldroot_rangers
diplomacy_CultureGroup_Rogue_WEF_Faction_WorldrootRangers_&_Negative	wh2_main_rogue_worldroot_rangers
diplomacy_CultureGroup_Rogue_WEF_Faction_WorldrootRangers_&_Positive	wh2_main_rogue_worldroot_rangers
diplomacy_CultureGroup_Rogue_WEF_Faction_WrathofNature	wh2_main_rogue_wrath_of_nature
diplomacy_CultureGroup_Rogue_WEF_Faction_WrathofNature_&_Negative	wh2_main_rogue_wrath_of_nature
diplomacy_CultureGroup_Rogue_WEF_Faction_WrathofNature_&_Positive	wh2_main_rogue_wrath_of_nature
diplomacy_FactionGroup_DE_Dreadlord2_Faction_CultofExcess	wh2_main_sc_def_dark_elves
diplomacy_FactionGroup_DE_Dreadlord2_Faction_CultofExcess_&_Negative	wh2_main_sc_def_dark_elves
diplomacy_FactionGroup_DE_Dreadlord2_Faction_CultofExcess_&_OtherFactionBeastmen	wh2_main_sc_def_dark_elves
diplomacy_FactionGroup_DE_Dreadlord2_Faction_CultofExcess_&_OtherFactionBeastmen_&_Negative	wh2_main_sc_def_dark_elves
diplomacy_FactionGroup_DE_Dreadlord2_Faction_CultofExcess_&_OtherFactionBeastmen_&_Positive	wh2_main_sc_def_dark_elves
diplomacy_FactionGroup_DE_Dreadlord2_Faction_CultofExcess_&_OtherFactionBretonnia	wh2_main_sc_def_dark_elves
diplomacy_FactionGroup_DE_Dreadlord2_Faction_CultofExcess_&_OtherFactionBretonnia_&_Negative	wh2_main_sc_def_dark_elves
diplomacy_FactionGroup_DE_Dreadlord2_Faction_CultofExcess_&_OtherFactionBretonnia_&_Positive	wh2_main_sc_def_dark_elves
diplomacy_FactionGroup_DE_Dreadlord2_Faction_CultofExcess_&_OtherFactionChaos	wh2_main_sc_def_dark_elves
diplomacy_FactionGroup_DE_Dreadlord2_Faction_CultofExcess_&_OtherFactionChaos_&_Negative	wh2_main_sc_def_dark_elves
diplomacy_FactionGroup_DE_Dreadlord2_Faction_CultofExcess_&_OtherFactionChaos_&_Positive	wh2_main_sc_def_dark_elves
diplomacy_FactionGroup_DE_Dreadlord2_Faction_CultofExcess_&_OtherFactionDarkElves	wh2_main_sc_def_dark_elves
diplomacy_FactionGroup_DE_Dreadlord2_Faction_CultofExcess_&_OtherFactionDarkElves_&_Negative	wh2_main_sc_def_dark_elves
diplomacy_FactionGroup_DE_Dreadlord2_Faction_CultofExcess_&_OtherFactionDarkElves_&_Positive	wh2_main_sc_def_dark_elves
diplomacy_FactionGroup_DE_Dreadlord2_Faction_CultofExcess_&_OtherFactionDwarf	wh2_main_sc_def_dark_elves
diplomacy_FactionGroup_DE_Dreadlord2_Faction_CultofExcess_&_OtherFactionDwarf_&_Negative	wh2_main_sc_def_dark_elves
diplomacy_FactionGroup_DE_Dreadlord2_Faction_CultofExcess_&_OtherFactionDwarf_&_Positive	wh2_main_sc_def_dark_elves
diplomacy_FactionGroup_DE_Dreadlord2_Faction_CultofExcess_&_OtherFactionEmpire	wh2_main_sc_def_dark_elves
diplomacy_FactionGroup_DE_Dreadlord2_Faction_CultofExcess_&_OtherFactionEmpire_&_Negative	wh2_main_sc_def_dark_elves
diplomacy_FactionGroup_DE_Dreadlord2_Faction_CultofExcess_&_OtherFactionEmpire_&_Positive	wh2_main_sc_def_dark_elves
diplomacy_FactionGroup_DE_Dreadlord2_Faction_CultofExcess_&_OtherFactionGreenskin	wh2_main_sc_def_dark_elves
diplomacy_FactionGroup_DE_Dreadlord2_Faction_CultofExcess_&_OtherFactionGreenskin_&_Negative	wh2_main_sc_def_dark_elves
diplomacy_FactionGroup_DE_Dreadlord2_Faction_CultofExcess_&_OtherFactionGreenskin_&_Positive	wh2_main_sc_def_dark_elves
diplomacy_FactionGroup_DE_Dreadlord2_Faction_CultofExcess_&_OtherFactionHighElves	wh2_main_sc_def_dark_elves
diplomacy_FactionGroup_DE_Dreadlord2_Faction_CultofExcess_&_OtherFactionHighElves_&_Negative	wh2_main_sc_def_dark_elves
diplomacy_FactionGroup_DE_Dreadlord2_Faction_CultofExcess_&_OtherFactionHighElves_&_Positive	wh2_main_sc_def_dark_elves
diplomacy_FactionGroup_DE_Dreadlord2_Faction_CultofExcess_&_OtherFactionLizardmen	wh2_main_sc_def_dark_elves
diplomacy_FactionGroup_DE_Dreadlord2_Faction_CultofExcess_&_OtherFactionLizardmen_&_Negative	wh2_main_sc_def_dark_elves
diplomacy_FactionGroup_DE_Dreadlord2_Faction_CultofExcess_&_OtherFactionLizardmen_&_Positive	wh2_main_sc_def_dark_elves
diplomacy_FactionGroup_DE_Dreadlord2_Faction_CultofExcess_&_OtherFactionSkaven	wh2_main_sc_def_dark_elves
diplomacy_FactionGroup_DE_Dreadlord2_Faction_CultofExcess_&_OtherFactionSkaven_&_Negative	wh2_main_sc_def_dark_elves
diplomacy_FactionGroup_DE_Dreadlord2_Faction_CultofExcess_&_OtherFactionSkaven_&_Positive	wh2_main_sc_def_dark_elves
diplomacy_FactionGroup_DE_Dreadlord2_Faction_CultofExcess_&_OtherFactionVamp	wh2_main_sc_def_dark_elves
diplomacy_FactionGroup_DE_Dreadlord2_Faction_CultofExcess_&_OtherFactionVamp_&_Negative	wh2_main_sc_def_dark_elves
diplomacy_FactionGroup_DE_Dreadlord2_Faction_CultofExcess_&_OtherFactionVamp_&_Positive	wh2_main_sc_def_dark_elves
diplomacy_FactionGroup_DE_Dreadlord2_Faction_CultofExcess_&_OtherFactionWoodElves	wh2_main_sc_def_dark_elves
diplomacy_FactionGroup_DE_Dreadlord2_Faction_CultofExcess_&_OtherFactionWoodElves_&_Negative	wh2_main_sc_def_dark_elves
diplomacy_FactionGroup_DE_Dreadlord2_Faction_CultofExcess_&_OtherFactionWoodElves_&_Positive	wh2_main_sc_def_dark_elves
diplomacy_FactionGroup_DE_Dreadlord2_Faction_CultofExcess_&_Positive	wh2_main_sc_def_dark_elves
diplomacy_FactionGroup_DE_Dreadlord2_Faction_DracklaCoven	wh2_main_sc_def_dark_elves
diplomacy_FactionGroup_DE_Dreadlord2_Faction_DracklaCoven_&_Negative	wh2_main_sc_def_dark_elves
diplomacy_FactionGroup_DE_Dreadlord2_Faction_DracklaCoven_&_OtherFactionBeastmen	wh2_main_sc_def_dark_elves
diplomacy_FactionGroup_DE_Dreadlord2_Faction_DracklaCoven_&_OtherFactionBeastmen_&_Negative	wh2_main_sc_def_dark_elves
diplomacy_FactionGroup_DE_Dreadlord2_Faction_DracklaCoven_&_OtherFactionBeastmen_&_Positive	wh2_main_sc_def_dark_elves
diplomacy_FactionGroup_DE_Dreadlord2_Faction_DracklaCoven_&_OtherFactionBretonnia	wh2_main_sc_def_dark_elves
diplomacy_FactionGroup_DE_Dreadlord2_Faction_DracklaCoven_&_OtherFactionBretonnia_&_Negative	wh2_main_sc_def_dark_elves
diplomacy_FactionGroup_DE_Dreadlord2_Faction_DracklaCoven_&_OtherFactionBretonnia_&_Positive	wh2_main_sc_def_dark_elves
diplomacy_FactionGroup_DE_Dreadlord2_Faction_DracklaCoven_&_OtherFactionChaos	wh2_main_sc_def_dark_elves
diplomacy_FactionGroup_DE_Dreadlord2_Faction_DracklaCoven_&_OtherFactionChaos_&_Negative	wh2_main_sc_def_dark_elves
diplomacy_FactionGroup_DE_Dreadlord2_Faction_DracklaCoven_&_OtherFactionChaos_&_Positive	wh2_main_sc_def_dark_elves
diplomacy_FactionGroup_DE_Dreadlord2_Faction_DracklaCoven_&_OtherFactionDarkElves	wh2_main_sc_def_dark_elves
diplomacy_FactionGroup_DE_Dreadlord2_Faction_DracklaCoven_&_OtherFactionDarkElves_&_Negative	wh2_main_sc_def_dark_elves
diplomacy_FactionGroup_DE_Dreadlord2_Faction_DracklaCoven_&_OtherFactionDarkElves_&_Positive	wh2_main_sc_def_dark_elves
diplomacy_FactionGroup_DE_Dreadlord2_Faction_DracklaCoven_&_OtherFactionDwarf	wh2_main_sc_def_dark_elves
diplomacy_FactionGroup_DE_Dreadlord2_Faction_DracklaCoven_&_OtherFactionDwarf_&_Negative	wh2_main_sc_def_dark_elves
diplomacy_FactionGroup_DE_Dreadlord2_Faction_DracklaCoven_&_OtherFactionDwarf_&_Positive	wh2_main_sc_def_dark_elves
diplomacy_FactionGroup_DE_Dreadlord2_Faction_DracklaCoven_&_OtherFactionEmpire	wh2_main_sc_def_dark_elves
diplomacy_FactionGroup_DE_Dreadlord2_Faction_DracklaCoven_&_OtherFactionEmpire_&_Negative	wh2_main_sc_def_dark_elves
diplomacy_FactionGroup_DE_Dreadlord2_Faction_DracklaCoven_&_OtherFactionEmpire_&_Positive	wh2_main_sc_def_dark_elves
diplomacy_FactionGroup_DE_Dreadlord2_Faction_DracklaCoven_&_OtherFactionGreenskin	wh2_main_sc_def_dark_elves
diplomacy_FactionGroup_DE_Dreadlord2_Faction_DracklaCoven_&_OtherFactionGreenskin_&_Negative	wh2_main_sc_def_dark_elves
diplomacy_FactionGroup_DE_Dreadlord2_Faction_DracklaCoven_&_OtherFactionGreenskin_&_Positive	wh2_main_sc_def_dark_elves
diplomacy_FactionGroup_DE_Dreadlord2_Faction_DracklaCoven_&_OtherFactionHighElves	wh2_main_sc_def_dark_elves
diplomacy_FactionGroup_DE_Dreadlord2_Faction_DracklaCoven_&_OtherFactionHighElves_&_Negative	wh2_main_sc_def_dark_elves
diplomacy_FactionGroup_DE_Dreadlord2_Faction_DracklaCoven_&_OtherFactionHighElves_&_Positive	wh2_main_sc_def_dark_elves
diplomacy_FactionGroup_DE_Dreadlord2_Faction_DracklaCoven_&_OtherFactionLizardmen	wh2_main_sc_def_dark_elves
diplomacy_FactionGroup_DE_Dreadlord2_Faction_DracklaCoven_&_OtherFactionLizardmen_&_Negative	wh2_main_sc_def_dark_elves
diplomacy_FactionGroup_DE_Dreadlord2_Faction_DracklaCoven_&_OtherFactionLizardmen_&_Positive	wh2_main_sc_def_dark_elves
diplomacy_FactionGroup_DE_Dreadlord2_Faction_DracklaCoven_&_OtherFactionSkaven	wh2_main_sc_def_dark_elves
diplomacy_FactionGroup_DE_Dreadlord2_Faction_DracklaCoven_&_OtherFactionSkaven_&_Negative	wh2_main_sc_def_dark_elves
diplomacy_FactionGroup_DE_Dreadlord2_Faction_DracklaCoven_&_OtherFactionSkaven_&_Positive	wh2_main_sc_def_dark_elves
diplomacy_FactionGroup_DE_Dreadlord2_Faction_DracklaCoven_&_OtherFactionVamp	wh2_main_sc_def_dark_elves
diplomacy_FactionGroup_DE_Dreadlord2_Faction_DracklaCoven_&_OtherFactionVamp_&_Negative	wh2_main_sc_def_dark_elves
diplomacy_FactionGroup_DE_Dreadlord2_Faction_DracklaCoven_&_OtherFactionVamp_&_Positive	wh2_main_sc_def_dark_elves
diplomacy_FactionGroup_DE_Dreadlord2_Faction_DracklaCoven_&_OtherFactionWoodElves	wh2_main_sc_def_dark_elves
diplomacy_FactionGroup_DE_Dreadlord2_Faction_DracklaCoven_&_OtherFactionWoodElves_&_Negative	wh2_main_sc_def_dark_elves
diplomacy_FactionGroup_DE_Dreadlord2_Faction_DracklaCoven_&_OtherFactionWoodElves_&_Positive	wh2_main_sc_def_dark_elves
diplomacy_FactionGroup_DE_Dreadlord2_Faction_DracklaCoven_&_Positive	wh2_main_sc_def_dark_elves
diplomacy_FactionGroup_DE_Dreadlord2_Faction_HarGaneth	wh2_main_sc_def_dark_elves
diplomacy_FactionGroup_DE_Dreadlord2_Faction_HarGaneth_&_Negative	wh2_main_sc_def_dark_elves
diplomacy_FactionGroup_DE_Dreadlord2_Faction_HarGaneth_&_OtherFactionBeastmen	wh2_main_sc_def_dark_elves
diplomacy_FactionGroup_DE_Dreadlord2_Faction_HarGaneth_&_OtherFactionBeastmen_&_Negative	wh2_main_sc_def_dark_elves
diplomacy_FactionGroup_DE_Dreadlord2_Faction_HarGaneth_&_OtherFactionBeastmen_&_Positive	wh2_main_sc_def_dark_elves
diplomacy_FactionGroup_DE_Dreadlord2_Faction_HarGaneth_&_OtherFactionBretonnia	wh2_main_sc_def_dark_elves
diplomacy_FactionGroup_DE_Dreadlord2_Faction_HarGaneth_&_OtherFactionBretonnia_&_Negative	wh2_main_sc_def_dark_elves
diplomacy_FactionGroup_DE_Dreadlord2_Faction_HarGaneth_&_OtherFactionBretonnia_&_Positive	wh2_main_sc_def_dark_elves
diplomacy_FactionGroup_DE_Dreadlord2_Faction_HarGaneth_&_OtherFactionChaos	wh2_main_sc_def_dark_elves
diplomacy_FactionGroup_DE_Dreadlord2_Faction_HarGaneth_&_OtherFactionChaos_&_Negative	wh2_main_sc_def_dark_elves
diplomacy_FactionGroup_DE_Dreadlord2_Faction_HarGaneth_&_OtherFactionChaos_&_Positive	wh2_main_sc_def_dark_elves
diplomacy_FactionGroup_DE_Dreadlord2_Faction_HarGaneth_&_OtherFactionDarkElves	wh2_main_sc_def_dark_elves
diplomacy_FactionGroup_DE_Dreadlord2_Faction_HarGaneth_&_OtherFactionDarkElves_&_Negative	wh2_main_sc_def_dark_elves
diplomacy_FactionGroup_DE_Dreadlord2_Faction_HarGaneth_&_OtherFactionDarkElves_&_Positive	wh2_main_sc_def_dark_elves
diplomacy_FactionGroup_DE_Dreadlord2_Faction_HarGaneth_&_OtherFactionDwarf	wh2_main_sc_def_dark_elves
diplomacy_FactionGroup_DE_Dreadlord2_Faction_HarGaneth_&_OtherFactionDwarf_&_Negative	wh2_main_sc_def_dark_elves
diplomacy_FactionGroup_DE_Dreadlord2_Faction_HarGaneth_&_OtherFactionDwarf_&_Positive	wh2_main_sc_def_dark_elves
diplomacy_FactionGroup_DE_Dreadlord2_Faction_HarGaneth_&_OtherFactionEmpire	wh2_main_sc_def_dark_elves
diplomacy_FactionGroup_DE_Dreadlord2_Faction_HarGaneth_&_OtherFactionEmpire_&_Negative	wh2_main_sc_def_dark_elves
diplomacy_FactionGroup_DE_Dreadlord2_Faction_HarGaneth_&_OtherFactionEmpire_&_Positive	wh2_main_sc_def_dark_elves
diplomacy_FactionGroup_DE_Dreadlord2_Faction_HarGaneth_&_OtherFactionGreenskin	wh2_main_sc_def_dark_elves
diplomacy_FactionGroup_DE_Dreadlord2_Faction_HarGaneth_&_OtherFactionGreenskin_&_Negative	wh2_main_sc_def_dark_elves
diplomacy_FactionGroup_DE_Dreadlord2_Faction_HarGaneth_&_OtherFactionGreenskin_&_Positive	wh2_main_sc_def_dark_elves
diplomacy_FactionGroup_DE_Dreadlord2_Faction_HarGaneth_&_OtherFactionHighElves	wh2_main_sc_def_dark_elves
diplomacy_FactionGroup_DE_Dreadlord2_Faction_HarGaneth_&_OtherFactionHighElves_&_Negative	wh2_main_sc_def_dark_elves
diplomacy_FactionGroup_DE_Dreadlord2_Faction_HarGaneth_&_OtherFactionHighElves_&_Positive	wh2_main_sc_def_dark_elves
diplomacy_FactionGroup_DE_Dreadlord2_Faction_HarGaneth_&_OtherFactionLizardmen	wh2_main_sc_def_dark_elves
diplomacy_FactionGroup_DE_Dreadlord2_Faction_HarGaneth_&_OtherFactionLizardmen_&_Negative	wh2_main_sc_def_dark_elves
diplomacy_FactionGroup_DE_Dreadlord2_Faction_HarGaneth_&_OtherFactionLizardmen_&_Positive	wh2_main_sc_def_dark_elves
diplomacy_FactionGroup_DE_Dreadlord2_Faction_HarGaneth_&_OtherFactionSkaven	wh2_main_sc_def_dark_elves
diplomacy_FactionGroup_DE_Dreadlord2_Faction_HarGaneth_&_OtherFactionSkaven_&_Negative	wh2_main_sc_def_dark_elves
diplomacy_FactionGroup_DE_Dreadlord2_Faction_HarGaneth_&_OtherFactionSkaven_&_Positive	wh2_main_sc_def_dark_elves
diplomacy_FactionGroup_DE_Dreadlord2_Faction_HarGaneth_&_OtherFactionVamp	wh2_main_sc_def_dark_elves
diplomacy_FactionGroup_DE_Dreadlord2_Faction_HarGaneth_&_OtherFactionVamp_&_Negative	wh2_main_sc_def_dark_elves
diplomacy_FactionGroup_DE_Dreadlord2_Faction_HarGaneth_&_OtherFactionVamp_&_Positive	wh2_main_sc_def_dark_elves
diplomacy_FactionGroup_DE_Dreadlord2_Faction_HarGaneth_&_OtherFactionWoodElves	wh2_main_sc_def_dark_elves
diplomacy_FactionGroup_DE_Dreadlord2_Faction_HarGaneth_&_OtherFactionWoodElves_&_Negative	wh2_main_sc_def_dark_elves
diplomacy_FactionGroup_DE_Dreadlord2_Faction_HarGaneth_&_OtherFactionWoodElves_&_Positive	wh2_main_sc_def_dark_elves
diplomacy_FactionGroup_DE_Dreadlord2_Faction_HarGaneth_&_Positive	wh2_main_sc_def_dark_elves
diplomacy_FactionGroup_DE_DreadlordFemale_Faction_ClarKarond	wh2_main_sc_def_dark_elves
diplomacy_FactionGroup_DE_DreadlordFemale_Faction_ClarKarond_&_Negative	wh2_main_sc_def_dark_elves
diplomacy_FactionGroup_DE_DreadlordFemale_Faction_ClarKarond_&_OtherFactionBeastmen	wh2_main_sc_def_dark_elves
diplomacy_FactionGroup_DE_DreadlordFemale_Faction_ClarKarond_&_OtherFactionBeastmen_&_Negative	wh2_main_sc_def_dark_elves
diplomacy_FactionGroup_DE_DreadlordFemale_Faction_ClarKarond_&_OtherFactionBeastmen_&_Positive	wh2_main_sc_def_dark_elves
diplomacy_FactionGroup_DE_DreadlordFemale_Faction_ClarKarond_&_OtherFactionBretonnia	wh2_main_sc_def_dark_elves
diplomacy_FactionGroup_DE_DreadlordFemale_Faction_ClarKarond_&_OtherFactionBretonnia_&_Negative	wh2_main_sc_def_dark_elves
diplomacy_FactionGroup_DE_DreadlordFemale_Faction_ClarKarond_&_OtherFactionBretonnia_&_Positive	wh2_main_sc_def_dark_elves
diplomacy_FactionGroup_DE_DreadlordFemale_Faction_ClarKarond_&_OtherFactionChaos	wh2_main_sc_def_dark_elves
diplomacy_FactionGroup_DE_DreadlordFemale_Faction_ClarKarond_&_OtherFactionChaos_&_Negative	wh2_main_sc_def_dark_elves
diplomacy_FactionGroup_DE_DreadlordFemale_Faction_ClarKarond_&_OtherFactionChaos_&_Positive	wh2_main_sc_def_dark_elves
diplomacy_FactionGroup_DE_DreadlordFemale_Faction_ClarKarond_&_OtherFactionDarkElves	wh2_main_sc_def_dark_elves
diplomacy_FactionGroup_DE_DreadlordFemale_Faction_ClarKarond_&_OtherFactionDarkElves_&_Negative	wh2_main_sc_def_dark_elves
diplomacy_FactionGroup_DE_DreadlordFemale_Faction_ClarKarond_&_OtherFactionDarkElves_&_Positive	wh2_main_sc_def_dark_elves
diplomacy_FactionGroup_DE_DreadlordFemale_Faction_ClarKarond_&_OtherFactionDwarf	wh2_main_sc_def_dark_elves
diplomacy_FactionGroup_DE_DreadlordFemale_Faction_ClarKarond_&_OtherFactionDwarf_&_Negative	wh2_main_sc_def_dark_elves
diplomacy_FactionGroup_DE_DreadlordFemale_Faction_ClarKarond_&_OtherFactionDwarf_&_Positive	wh2_main_sc_def_dark_elves
diplomacy_FactionGroup_DE_DreadlordFemale_Faction_ClarKarond_&_OtherFactionEmpire	wh2_main_sc_def_dark_elves
diplomacy_FactionGroup_DE_DreadlordFemale_Faction_ClarKarond_&_OtherFactionEmpire_&_Negative	wh2_main_sc_def_dark_elves
diplomacy_FactionGroup_DE_DreadlordFemale_Faction_ClarKarond_&_OtherFactionEmpire_&_Positive	wh2_main_sc_def_dark_elves
diplomacy_FactionGroup_DE_DreadlordFemale_Faction_ClarKarond_&_OtherFactionGreenskin	wh2_main_sc_def_dark_elves
diplomacy_FactionGroup_DE_DreadlordFemale_Faction_ClarKarond_&_OtherFactionGreenskin_&_Negative	wh2_main_sc_def_dark_elves
diplomacy_FactionGroup_DE_DreadlordFemale_Faction_ClarKarond_&_OtherFactionGreenskin_&_Positive	wh2_main_sc_def_dark_elves
diplomacy_FactionGroup_DE_DreadlordFemale_Faction_ClarKarond_&_OtherFactionHighElves	wh2_main_sc_def_dark_elves
diplomacy_FactionGroup_DE_DreadlordFemale_Faction_ClarKarond_&_OtherFactionHighElves_&_Negative	wh2_main_sc_def_dark_elves
diplomacy_FactionGroup_DE_DreadlordFemale_Faction_ClarKarond_&_OtherFactionHighElves_&_Positive	wh2_main_sc_def_dark_elves
diplomacy_FactionGroup_DE_DreadlordFemale_Faction_ClarKarond_&_OtherFactionLizardmen	wh2_main_sc_def_dark_elves
diplomacy_FactionGroup_DE_DreadlordFemale_Faction_ClarKarond_&_OtherFactionLizardmen_&_Negative	wh2_main_sc_def_dark_elves
diplomacy_FactionGroup_DE_DreadlordFemale_Faction_ClarKarond_&_OtherFactionLizardmen_&_Positive	wh2_main_sc_def_dark_elves
diplomacy_FactionGroup_DE_DreadlordFemale_Faction_ClarKarond_&_OtherFactionSkaven	wh2_main_sc_def_dark_elves
diplomacy_FactionGroup_DE_DreadlordFemale_Faction_ClarKarond_&_OtherFactionSkaven_&_Negative	wh2_main_sc_def_dark_elves
diplomacy_FactionGroup_DE_DreadlordFemale_Faction_ClarKarond_&_OtherFactionSkaven_&_Positive	wh2_main_sc_def_dark_elves
diplomacy_FactionGroup_DE_DreadlordFemale_Faction_ClarKarond_&_OtherFactionVamp	wh2_main_sc_def_dark_elves
diplomacy_FactionGroup_DE_DreadlordFemale_Faction_ClarKarond_&_OtherFactionVamp_&_Negative	wh2_main_sc_def_dark_elves
diplomacy_FactionGroup_DE_DreadlordFemale_Faction_ClarKarond_&_OtherFactionVamp_&_Positive	wh2_main_sc_def_dark_elves
diplomacy_FactionGroup_DE_DreadlordFemale_Faction_ClarKarond_&_OtherFactionWoodElves	wh2_main_sc_def_dark_elves
diplomacy_FactionGroup_DE_DreadlordFemale_Faction_ClarKarond_&_OtherFactionWoodElves_&_Negative	wh2_main_sc_def_dark_elves
diplomacy_FactionGroup_DE_DreadlordFemale_Faction_ClarKarond_&_OtherFactionWoodElves_&_Positive	wh2_main_sc_def_dark_elves
diplomacy_FactionGroup_DE_DreadlordFemale_Faction_ClarKarond_&_Positive	wh2_main_sc_def_dark_elves
diplomacy_FactionGroup_DE_DreadlordFemale_Faction_HagGraef	wh2_main_sc_def_dark_elves
diplomacy_FactionGroup_DE_DreadlordFemale_Faction_HagGraef_&_Negative	wh2_main_sc_def_dark_elves
diplomacy_FactionGroup_DE_DreadlordFemale_Faction_HagGraef_&_OtherFactionBeastmen	wh2_main_sc_def_dark_elves
diplomacy_FactionGroup_DE_DreadlordFemale_Faction_HagGraef_&_OtherFactionBeastmen_&_Negative	wh2_main_sc_def_dark_elves
diplomacy_FactionGroup_DE_DreadlordFemale_Faction_HagGraef_&_OtherFactionBeastmen_&_Positive	wh2_main_sc_def_dark_elves
diplomacy_FactionGroup_DE_DreadlordFemale_Faction_HagGraef_&_OtherFactionBretonnia	wh2_main_sc_def_dark_elves
diplomacy_FactionGroup_DE_DreadlordFemale_Faction_HagGraef_&_OtherFactionBretonnia_&_Negative	wh2_main_sc_def_dark_elves
diplomacy_FactionGroup_DE_DreadlordFemale_Faction_HagGraef_&_OtherFactionBretonnia_&_Positive	wh2_main_sc_def_dark_elves
diplomacy_FactionGroup_DE_DreadlordFemale_Faction_HagGraef_&_OtherFactionChaos	wh2_main_sc_def_dark_elves
diplomacy_FactionGroup_DE_DreadlordFemale_Faction_HagGraef_&_OtherFactionChaos_&_Negative	wh2_main_sc_def_dark_elves
diplomacy_FactionGroup_DE_DreadlordFemale_Faction_HagGraef_&_OtherFactionChaos_&_Positive	wh2_main_sc_def_dark_elves
diplomacy_FactionGroup_DE_DreadlordFemale_Faction_HagGraef_&_OtherFactionDarkElves	wh2_main_sc_def_dark_elves
diplomacy_FactionGroup_DE_DreadlordFemale_Faction_HagGraef_&_OtherFactionDarkElves_&_Negative	wh2_main_sc_def_dark_elves
diplomacy_FactionGroup_DE_DreadlordFemale_Faction_HagGraef_&_OtherFactionDarkElves_&_Positive	wh2_main_sc_def_dark_elves
diplomacy_FactionGroup_DE_DreadlordFemale_Faction_HagGraef_&_OtherFactionDwarf	wh2_main_sc_def_dark_elves
diplomacy_FactionGroup_DE_DreadlordFemale_Faction_HagGraef_&_OtherFactionDwarf_&_Negative	wh2_main_sc_def_dark_elves
diplomacy_FactionGroup_DE_DreadlordFemale_Faction_HagGraef_&_OtherFactionDwarf_&_Positive	wh2_main_sc_def_dark_elves
diplomacy_FactionGroup_DE_DreadlordFemale_Faction_HagGraef_&_OtherFactionEmpire	wh2_main_sc_def_dark_elves
diplomacy_FactionGroup_DE_DreadlordFemale_Faction_HagGraef_&_OtherFactionEmpire_&_Negative	wh2_main_sc_def_dark_elves
diplomacy_FactionGroup_DE_DreadlordFemale_Faction_HagGraef_&_OtherFactionEmpire_&_Positive	wh2_main_sc_def_dark_elves
diplomacy_FactionGroup_DE_DreadlordFemale_Faction_HagGraef_&_OtherFactionGreenskin	wh2_main_sc_def_dark_elves
diplomacy_FactionGroup_DE_DreadlordFemale_Faction_HagGraef_&_OtherFactionGreenskin_&_Negative	wh2_main_sc_def_dark_elves
diplomacy_FactionGroup_DE_DreadlordFemale_Faction_HagGraef_&_OtherFactionGreenskin_&_Positive	wh2_main_sc_def_dark_elves
diplomacy_FactionGroup_DE_DreadlordFemale_Faction_HagGraef_&_OtherFactionHighElves	wh2_main_sc_def_dark_elves
diplomacy_FactionGroup_DE_DreadlordFemale_Faction_HagGraef_&_OtherFactionHighElves_&_Negative	wh2_main_sc_def_dark_elves
diplomacy_FactionGroup_DE_DreadlordFemale_Faction_HagGraef_&_OtherFactionHighElves_&_Positive	wh2_main_sc_def_dark_elves
diplomacy_FactionGroup_DE_DreadlordFemale_Faction_HagGraef_&_OtherFactionLizardmen	wh2_main_sc_def_dark_elves
diplomacy_FactionGroup_DE_DreadlordFemale_Faction_HagGraef_&_OtherFactionLizardmen_&_Negative	wh2_main_sc_def_dark_elves
diplomacy_FactionGroup_DE_DreadlordFemale_Faction_HagGraef_&_OtherFactionLizardmen_&_Positive	wh2_main_sc_def_dark_elves
diplomacy_FactionGroup_DE_DreadlordFemale_Faction_HagGraef_&_OtherFactionSkaven	wh2_main_sc_def_dark_elves
diplomacy_FactionGroup_DE_DreadlordFemale_Faction_HagGraef_&_OtherFactionSkaven_&_Negative	wh2_main_sc_def_dark_elves
diplomacy_FactionGroup_DE_DreadlordFemale_Faction_HagGraef_&_OtherFactionSkaven_&_Positive	wh2_main_sc_def_dark_elves
diplomacy_FactionGroup_DE_DreadlordFemale_Faction_HagGraef_&_OtherFactionVamp	wh2_main_sc_def_dark_elves
diplomacy_FactionGroup_DE_DreadlordFemale_Faction_HagGraef_&_OtherFactionVamp_&_Negative	wh2_main_sc_def_dark_elves
diplomacy_FactionGroup_DE_DreadlordFemale_Faction_HagGraef_&_OtherFactionVamp_&_Positive	wh2_main_sc_def_dark_elves
diplomacy_FactionGroup_DE_DreadlordFemale_Faction_HagGraef_&_OtherFactionWoodElves	wh2_main_sc_def_dark_elves
diplomacy_FactionGroup_DE_DreadlordFemale_Faction_HagGraef_&_OtherFactionWoodElves_&_Negative	wh2_main_sc_def_dark_elves
diplomacy_FactionGroup_DE_DreadlordFemale_Faction_HagGraef_&_OtherFactionWoodElves_&_Positive	wh2_main_sc_def_dark_elves
diplomacy_FactionGroup_DE_DreadlordFemale_Faction_HagGraef_&_Positive	wh2_main_sc_def_dark_elves
diplomacy_FactionGroup_DE_DreadlordFemale_Faction_KarondKar	wh2_main_sc_def_dark_elves
diplomacy_FactionGroup_DE_DreadlordFemale_Faction_KarondKar_&_Negative	wh2_main_sc_def_dark_elves
diplomacy_FactionGroup_DE_DreadlordFemale_Faction_KarondKar_&_OtherFactionBeastmen	wh2_main_sc_def_dark_elves
diplomacy_FactionGroup_DE_DreadlordFemale_Faction_KarondKar_&_OtherFactionBeastmen_&_Negative	wh2_main_sc_def_dark_elves
diplomacy_FactionGroup_DE_DreadlordFemale_Faction_KarondKar_&_OtherFactionBeastmen_&_Positive	wh2_main_sc_def_dark_elves
diplomacy_FactionGroup_DE_DreadlordFemale_Faction_KarondKar_&_OtherFactionBretonnia	wh2_main_sc_def_dark_elves
diplomacy_FactionGroup_DE_DreadlordFemale_Faction_KarondKar_&_OtherFactionBretonnia_&_Negative	wh2_main_sc_def_dark_elves
diplomacy_FactionGroup_DE_DreadlordFemale_Faction_KarondKar_&_OtherFactionBretonnia_&_Positive	wh2_main_sc_def_dark_elves
diplomacy_FactionGroup_DE_DreadlordFemale_Faction_KarondKar_&_OtherFactionChaos	wh2_main_sc_def_dark_elves
diplomacy_FactionGroup_DE_DreadlordFemale_Faction_KarondKar_&_OtherFactionChaos_&_Negative	wh2_main_sc_def_dark_elves
diplomacy_FactionGroup_DE_DreadlordFemale_Faction_KarondKar_&_OtherFactionChaos_&_Positive	wh2_main_sc_def_dark_elves
diplomacy_FactionGroup_DE_DreadlordFemale_Faction_KarondKar_&_OtherFactionDarkElves	wh2_main_sc_def_dark_elves
diplomacy_FactionGroup_DE_DreadlordFemale_Faction_KarondKar_&_OtherFactionDarkElves_&_Negative	wh2_main_sc_def_dark_elves
diplomacy_FactionGroup_DE_DreadlordFemale_Faction_KarondKar_&_OtherFactionDarkElves_&_Positive	wh2_main_sc_def_dark_elves
diplomacy_FactionGroup_DE_DreadlordFemale_Faction_KarondKar_&_OtherFactionDwarf	wh2_main_sc_def_dark_elves
diplomacy_FactionGroup_DE_DreadlordFemale_Faction_KarondKar_&_OtherFactionDwarf_&_Negative	wh2_main_sc_def_dark_elves
diplomacy_FactionGroup_DE_DreadlordFemale_Faction_KarondKar_&_OtherFactionDwarf_&_Positive	wh2_main_sc_def_dark_elves
diplomacy_FactionGroup_DE_DreadlordFemale_Faction_KarondKar_&_OtherFactionEmpire	wh2_main_sc_def_dark_elves
diplomacy_FactionGroup_DE_DreadlordFemale_Faction_KarondKar_&_OtherFactionEmpire_&_Negative	wh2_main_sc_def_dark_elves
diplomacy_FactionGroup_DE_DreadlordFemale_Faction_KarondKar_&_OtherFactionEmpire_&_Positive	wh2_main_sc_def_dark_elves
diplomacy_FactionGroup_DE_DreadlordFemale_Faction_KarondKar_&_OtherFactionGreenskin	wh2_main_sc_def_dark_elves
diplomacy_FactionGroup_DE_DreadlordFemale_Faction_KarondKar_&_OtherFactionGreenskin_&_Negative	wh2_main_sc_def_dark_elves
diplomacy_FactionGroup_DE_DreadlordFemale_Faction_KarondKar_&_OtherFactionGreenskin_&_Positive	wh2_main_sc_def_dark_elves
diplomacy_FactionGroup_DE_DreadlordFemale_Faction_KarondKar_&_OtherFactionHighElves	wh2_main_sc_def_dark_elves
diplomacy_FactionGroup_DE_DreadlordFemale_Faction_KarondKar_&_OtherFactionHighElves_&_Negative	wh2_main_sc_def_dark_elves
diplomacy_FactionGroup_DE_DreadlordFemale_Faction_KarondKar_&_OtherFactionHighElves_&_Positive	wh2_main_sc_def_dark_elves
diplomacy_FactionGroup_DE_DreadlordFemale_Faction_KarondKar_&_OtherFactionLizardmen	wh2_main_sc_def_dark_elves
diplomacy_FactionGroup_DE_DreadlordFemale_Faction_KarondKar_&_OtherFactionLizardmen_&_Negative	wh2_main_sc_def_dark_elves
diplomacy_FactionGroup_DE_DreadlordFemale_Faction_KarondKar_&_OtherFactionLizardmen_&_Positive	wh2_main_sc_def_dark_elves
diplomacy_FactionGroup_DE_DreadlordFemale_Faction_KarondKar_&_OtherFactionSkaven	wh2_main_sc_def_dark_elves
diplomacy_FactionGroup_DE_DreadlordFemale_Faction_KarondKar_&_OtherFactionSkaven_&_Negative	wh2_main_sc_def_dark_elves
diplomacy_FactionGroup_DE_DreadlordFemale_Faction_KarondKar_&_OtherFactionSkaven_&_Positive	wh2_main_sc_def_dark_elves
diplomacy_FactionGroup_DE_DreadlordFemale_Faction_KarondKar_&_OtherFactionVamp	wh2_main_sc_def_dark_elves
diplomacy_FactionGroup_DE_DreadlordFemale_Faction_KarondKar_&_OtherFactionVamp_&_Negative	wh2_main_sc_def_dark_elves
diplomacy_FactionGroup_DE_DreadlordFemale_Faction_KarondKar_&_OtherFactionVamp_&_Positive	wh2_main_sc_def_dark_elves
diplomacy_FactionGroup_DE_DreadlordFemale_Faction_KarondKar_&_OtherFactionWoodElves	wh2_main_sc_def_dark_elves
diplomacy_FactionGroup_DE_DreadlordFemale_Faction_KarondKar_&_OtherFactionWoodElves_&_Negative	wh2_main_sc_def_dark_elves
diplomacy_FactionGroup_DE_DreadlordFemale_Faction_KarondKar_&_OtherFactionWoodElves_&_Positive	wh2_main_sc_def_dark_elves
diplomacy_FactionGroup_DE_DreadlordFemale_Faction_KarondKar_&_Positive	wh2_main_sc_def_dark_elves
diplomacy_FactionGroup_DE_DreadlordFemale_Faction_SsildraTor	wh2_main_sc_def_dark_elves
diplomacy_FactionGroup_DE_DreadlordFemale_Faction_SsildraTor_&_Negative	wh2_main_sc_def_dark_elves
diplomacy_FactionGroup_DE_DreadlordFemale_Faction_SsildraTor_&_OtherFactionBeastmen	wh2_main_sc_def_dark_elves
diplomacy_FactionGroup_DE_DreadlordFemale_Faction_SsildraTor_&_OtherFactionBeastmen_&_Negative	wh2_main_sc_def_dark_elves
diplomacy_FactionGroup_DE_DreadlordFemale_Faction_SsildraTor_&_OtherFactionBeastmen_&_Positive	wh2_main_sc_def_dark_elves
diplomacy_FactionGroup_DE_DreadlordFemale_Faction_SsildraTor_&_OtherFactionBretonnia	wh2_main_sc_def_dark_elves
diplomacy_FactionGroup_DE_DreadlordFemale_Faction_SsildraTor_&_OtherFactionBretonnia_&_Negative	wh2_main_sc_def_dark_elves
diplomacy_FactionGroup_DE_DreadlordFemale_Faction_SsildraTor_&_OtherFactionBretonnia_&_Positive	wh2_main_sc_def_dark_elves
diplomacy_FactionGroup_DE_DreadlordFemale_Faction_SsildraTor_&_OtherFactionChaos	wh2_main_sc_def_dark_elves
diplomacy_FactionGroup_DE_DreadlordFemale_Faction_SsildraTor_&_OtherFactionChaos_&_Negative	wh2_main_sc_def_dark_elves
diplomacy_FactionGroup_DE_DreadlordFemale_Faction_SsildraTor_&_OtherFactionChaos_&_Positive	wh2_main_sc_def_dark_elves
diplomacy_FactionGroup_DE_DreadlordFemale_Faction_SsildraTor_&_OtherFactionDarkElves	wh2_main_sc_def_dark_elves
diplomacy_FactionGroup_DE_DreadlordFemale_Faction_SsildraTor_&_OtherFactionDarkElves_&_Negative	wh2_main_sc_def_dark_elves
diplomacy_FactionGroup_DE_DreadlordFemale_Faction_SsildraTor_&_OtherFactionDarkElves_&_Positive	wh2_main_sc_def_dark_elves
diplomacy_FactionGroup_DE_DreadlordFemale_Faction_SsildraTor_&_OtherFactionDwarf	wh2_main_sc_def_dark_elves
diplomacy_FactionGroup_DE_DreadlordFemale_Faction_SsildraTor_&_OtherFactionDwarf_&_Negative	wh2_main_sc_def_dark_elves
diplomacy_FactionGroup_DE_DreadlordFemale_Faction_SsildraTor_&_OtherFactionDwarf_&_Positive	wh2_main_sc_def_dark_elves
diplomacy_FactionGroup_DE_DreadlordFemale_Faction_SsildraTor_&_OtherFactionEmpire	wh2_main_sc_def_dark_elves
diplomacy_FactionGroup_DE_DreadlordFemale_Faction_SsildraTor_&_OtherFactionEmpire_&_Negative	wh2_main_sc_def_dark_elves
diplomacy_FactionGroup_DE_DreadlordFemale_Faction_SsildraTor_&_OtherFactionEmpire_&_Positive	wh2_main_sc_def_dark_elves
diplomacy_FactionGroup_DE_DreadlordFemale_Faction_SsildraTor_&_OtherFactionGreenskin	wh2_main_sc_def_dark_elves
diplomacy_FactionGroup_DE_DreadlordFemale_Faction_SsildraTor_&_OtherFactionGreenskin_&_Negative	wh2_main_sc_def_dark_elves
diplomacy_FactionGroup_DE_DreadlordFemale_Faction_SsildraTor_&_OtherFactionGreenskin_&_Positive	wh2_main_sc_def_dark_elves
diplomacy_FactionGroup_DE_DreadlordFemale_Faction_SsildraTor_&_OtherFactionHighElves	wh2_main_sc_def_dark_elves
diplomacy_FactionGroup_DE_DreadlordFemale_Faction_SsildraTor_&_OtherFactionHighElves_&_Negative	wh2_main_sc_def_dark_elves
diplomacy_FactionGroup_DE_DreadlordFemale_Faction_SsildraTor_&_OtherFactionHighElves_&_Positive	wh2_main_sc_def_dark_elves
diplomacy_FactionGroup_DE_DreadlordFemale_Faction_SsildraTor_&_OtherFactionLizardmen	wh2_main_sc_def_dark_elves
diplomacy_FactionGroup_DE_DreadlordFemale_Faction_SsildraTor_&_OtherFactionLizardmen_&_Negative	wh2_main_sc_def_dark_elves
diplomacy_FactionGroup_DE_DreadlordFemale_Faction_SsildraTor_&_OtherFactionLizardmen_&_Positive	wh2_main_sc_def_dark_elves
diplomacy_FactionGroup_DE_DreadlordFemale_Faction_SsildraTor_&_OtherFactionSkaven	wh2_main_sc_def_dark_elves
diplomacy_FactionGroup_DE_DreadlordFemale_Faction_SsildraTor_&_OtherFactionSkaven_&_Negative	wh2_main_sc_def_dark_elves
diplomacy_FactionGroup_DE_DreadlordFemale_Faction_SsildraTor_&_OtherFactionSkaven_&_Positive	wh2_main_sc_def_dark_elves
diplomacy_FactionGroup_DE_DreadlordFemale_Faction_SsildraTor_&_OtherFactionVamp	wh2_main_sc_def_dark_elves
diplomacy_FactionGroup_DE_DreadlordFemale_Faction_SsildraTor_&_OtherFactionVamp_&_Negative	wh2_main_sc_def_dark_elves
diplomacy_FactionGroup_DE_DreadlordFemale_Faction_SsildraTor_&_OtherFactionVamp_&_Positive	wh2_main_sc_def_dark_elves
diplomacy_FactionGroup_DE_DreadlordFemale_Faction_SsildraTor_&_OtherFactionWoodElves	wh2_main_sc_def_dark_elves
diplomacy_FactionGroup_DE_DreadlordFemale_Faction_SsildraTor_&_OtherFactionWoodElves_&_Negative	wh2_main_sc_def_dark_elves
diplomacy_FactionGroup_DE_DreadlordFemale_Faction_SsildraTor_&_OtherFactionWoodElves_&_Positive	wh2_main_sc_def_dark_elves
diplomacy_FactionGroup_DE_DreadlordFemale_Faction_SsildraTor_&_Positive	wh2_main_sc_def_dark_elves
diplomacy_FactionGroup_DE_DreadlordFemale_Faction_TheForgebound	wh2_main_sc_def_dark_elves
diplomacy_FactionGroup_DE_DreadlordFemale_Faction_TheForgebound_&_Negative	wh2_main_sc_def_dark_elves
diplomacy_FactionGroup_DE_DreadlordFemale_Faction_TheForgebound_&_OtherFactionBeastmen	wh2_main_sc_def_dark_elves
diplomacy_FactionGroup_DE_DreadlordFemale_Faction_TheForgebound_&_OtherFactionBeastmen_&_Negative	wh2_main_sc_def_dark_elves
diplomacy_FactionGroup_DE_DreadlordFemale_Faction_TheForgebound_&_OtherFactionBeastmen_&_Positive	wh2_main_sc_def_dark_elves
diplomacy_FactionGroup_DE_DreadlordFemale_Faction_TheForgebound_&_OtherFactionBretonnia	wh2_main_sc_def_dark_elves
diplomacy_FactionGroup_DE_DreadlordFemale_Faction_TheForgebound_&_OtherFactionBretonnia_&_Negative	wh2_main_sc_def_dark_elves
diplomacy_FactionGroup_DE_DreadlordFemale_Faction_TheForgebound_&_OtherFactionBretonnia_&_Positive	wh2_main_sc_def_dark_elves
diplomacy_FactionGroup_DE_DreadlordFemale_Faction_TheForgebound_&_OtherFactionChaos	wh2_main_sc_def_dark_elves
diplomacy_FactionGroup_DE_DreadlordFemale_Faction_TheForgebound_&_OtherFactionChaos_&_Negative	wh2_main_sc_def_dark_elves
diplomacy_FactionGroup_DE_DreadlordFemale_Faction_TheForgebound_&_OtherFactionChaos_&_Positive	wh2_main_sc_def_dark_elves
diplomacy_FactionGroup_DE_DreadlordFemale_Faction_TheForgebound_&_OtherFactionDarkElves	wh2_main_sc_def_dark_elves
diplomacy_FactionGroup_DE_DreadlordFemale_Faction_TheForgebound_&_OtherFactionDarkElves_&_Negative	wh2_main_sc_def_dark_elves
diplomacy_FactionGroup_DE_DreadlordFemale_Faction_TheForgebound_&_OtherFactionDarkElves_&_Positive	wh2_main_sc_def_dark_elves
diplomacy_FactionGroup_DE_DreadlordFemale_Faction_TheForgebound_&_OtherFactionDwarf	wh2_main_sc_def_dark_elves
diplomacy_FactionGroup_DE_DreadlordFemale_Faction_TheForgebound_&_OtherFactionDwarf_&_Negative	wh2_main_sc_def_dark_elves
diplomacy_FactionGroup_DE_DreadlordFemale_Faction_TheForgebound_&_OtherFactionDwarf_&_Positive	wh2_main_sc_def_dark_elves
diplomacy_FactionGroup_DE_DreadlordFemale_Faction_TheForgebound_&_OtherFactionEmpire	wh2_main_sc_def_dark_elves
diplomacy_FactionGroup_DE_DreadlordFemale_Faction_TheForgebound_&_OtherFactionEmpire_&_Negative	wh2_main_sc_def_dark_elves
diplomacy_FactionGroup_DE_DreadlordFemale_Faction_TheForgebound_&_OtherFactionEmpire_&_Positive	wh2_main_sc_def_dark_elves
diplomacy_FactionGroup_DE_DreadlordFemale_Faction_TheForgebound_&_OtherFactionGreenskin	wh2_main_sc_def_dark_elves
diplomacy_FactionGroup_DE_DreadlordFemale_Faction_TheForgebound_&_OtherFactionGreenskin_&_Negative	wh2_main_sc_def_dark_elves
diplomacy_FactionGroup_DE_DreadlordFemale_Faction_TheForgebound_&_OtherFactionGreenskin_&_Positive	wh2_main_sc_def_dark_elves
diplomacy_FactionGroup_DE_DreadlordFemale_Faction_TheForgebound_&_OtherFactionHighElves	wh2_main_sc_def_dark_elves
diplomacy_FactionGroup_DE_DreadlordFemale_Faction_TheForgebound_&_OtherFactionHighElves_&_Negative	wh2_main_sc_def_dark_elves
diplomacy_FactionGroup_DE_DreadlordFemale_Faction_TheForgebound_&_OtherFactionHighElves_&_Positive	wh2_main_sc_def_dark_elves
diplomacy_FactionGroup_DE_DreadlordFemale_Faction_TheForgebound_&_OtherFactionLizardmen	wh2_main_sc_def_dark_elves
diplomacy_FactionGroup_DE_DreadlordFemale_Faction_TheForgebound_&_OtherFactionLizardmen_&_Negative	wh2_main_sc_def_dark_elves
diplomacy_FactionGroup_DE_DreadlordFemale_Faction_TheForgebound_&_OtherFactionLizardmen_&_Positive	wh2_main_sc_def_dark_elves
diplomacy_FactionGroup_DE_DreadlordFemale_Faction_TheForgebound_&_OtherFactionSkaven	wh2_main_sc_def_dark_elves
diplomacy_FactionGroup_DE_DreadlordFemale_Faction_TheForgebound_&_OtherFactionSkaven_&_Negative	wh2_main_sc_def_dark_elves
diplomacy_FactionGroup_DE_DreadlordFemale_Faction_TheForgebound_&_OtherFactionSkaven_&_Positive	wh2_main_sc_def_dark_elves
diplomacy_FactionGroup_DE_DreadlordFemale_Faction_TheForgebound_&_OtherFactionVamp	wh2_main_sc_def_dark_elves
diplomacy_FactionGroup_DE_DreadlordFemale_Faction_TheForgebound_&_OtherFactionVamp_&_Negative	wh2_main_sc_def_dark_elves
diplomacy_FactionGroup_DE_DreadlordFemale_Faction_TheForgebound_&_OtherFactionVamp_&_Positive	wh2_main_sc_def_dark_elves
diplomacy_FactionGroup_DE_DreadlordFemale_Faction_TheForgebound_&_OtherFactionWoodElves	wh2_main_sc_def_dark_elves
diplomacy_FactionGroup_DE_DreadlordFemale_Faction_TheForgebound_&_OtherFactionWoodElves_&_Negative	wh2_main_sc_def_dark_elves
diplomacy_FactionGroup_DE_DreadlordFemale_Faction_TheForgebound_&_OtherFactionWoodElves_&_Positive	wh2_main_sc_def_dark_elves
diplomacy_FactionGroup_DE_DreadlordFemale_Faction_TheForgebound_&_Positive	wh2_main_sc_def_dark_elves
diplomacy_FactionGroup_HE_Prince2_Faction_Chrace	wh2_main_sc_hef_high_elves
diplomacy_FactionGroup_HE_Prince2_Faction_Chrace_&_Negative	wh2_main_sc_hef_high_elves
diplomacy_FactionGroup_HE_Prince2_Faction_Chrace_&_OtherFactionBeastmen	wh2_main_sc_hef_high_elves
diplomacy_FactionGroup_HE_Prince2_Faction_Chrace_&_OtherFactionBeastmen_&_Negative	wh2_main_sc_hef_high_elves
diplomacy_FactionGroup_HE_Prince2_Faction_Chrace_&_OtherFactionBeastmen_&_Positive	wh2_main_sc_hef_high_elves
diplomacy_FactionGroup_HE_Prince2_Faction_Chrace_&_OtherFactionBretonnia	wh2_main_sc_hef_high_elves
diplomacy_FactionGroup_HE_Prince2_Faction_Chrace_&_OtherFactionBretonnia_&_Negative	wh2_main_sc_hef_high_elves
diplomacy_FactionGroup_HE_Prince2_Faction_Chrace_&_OtherFactionBretonnia_&_Positive	wh2_main_sc_hef_high_elves
diplomacy_FactionGroup_HE_Prince2_Faction_Chrace_&_OtherFactionChaos	wh2_main_sc_hef_high_elves
diplomacy_FactionGroup_HE_Prince2_Faction_Chrace_&_OtherFactionChaos_&_Negative	wh2_main_sc_hef_high_elves
diplomacy_FactionGroup_HE_Prince2_Faction_Chrace_&_OtherFactionChaos_&_Positive	wh2_main_sc_hef_high_elves
diplomacy_FactionGroup_HE_Prince2_Faction_Chrace_&_OtherFactionDarkElves	wh2_main_sc_hef_high_elves
diplomacy_FactionGroup_HE_Prince2_Faction_Chrace_&_OtherFactionDarkElves_&_Negative	wh2_main_sc_hef_high_elves
diplomacy_FactionGroup_HE_Prince2_Faction_Chrace_&_OtherFactionDarkElves_&_Positive	wh2_main_sc_hef_high_elves
diplomacy_FactionGroup_HE_Prince2_Faction_Chrace_&_OtherFactionDwarf	wh2_main_sc_hef_high_elves
diplomacy_FactionGroup_HE_Prince2_Faction_Chrace_&_OtherFactionDwarf_&_Negative	wh2_main_sc_hef_high_elves
diplomacy_FactionGroup_HE_Prince2_Faction_Chrace_&_OtherFactionDwarf_&_Positive	wh2_main_sc_hef_high_elves
diplomacy_FactionGroup_HE_Prince2_Faction_Chrace_&_OtherFactionEmpire	wh2_main_sc_hef_high_elves
diplomacy_FactionGroup_HE_Prince2_Faction_Chrace_&_OtherFactionEmpire_&_Negative	wh2_main_sc_hef_high_elves
diplomacy_FactionGroup_HE_Prince2_Faction_Chrace_&_OtherFactionEmpire_&_Positive	wh2_main_sc_hef_high_elves
diplomacy_FactionGroup_HE_Prince2_Faction_Chrace_&_OtherFactionGreenskin	wh2_main_sc_hef_high_elves
diplomacy_FactionGroup_HE_Prince2_Faction_Chrace_&_OtherFactionGreenskin_&_Negative	wh2_main_sc_hef_high_elves
diplomacy_FactionGroup_HE_Prince2_Faction_Chrace_&_OtherFactionGreenskin_&_Positive	wh2_main_sc_hef_high_elves
diplomacy_FactionGroup_HE_Prince2_Faction_Chrace_&_OtherFactionHighElves	wh2_main_sc_hef_high_elves
diplomacy_FactionGroup_HE_Prince2_Faction_Chrace_&_OtherFactionHighElves_&_Negative	wh2_main_sc_hef_high_elves
diplomacy_FactionGroup_HE_Prince2_Faction_Chrace_&_OtherFactionHighElves_&_Positive	wh2_main_sc_hef_high_elves
diplomacy_FactionGroup_HE_Prince2_Faction_Chrace_&_OtherFactionLizardmen	wh2_main_sc_hef_high_elves
diplomacy_FactionGroup_HE_Prince2_Faction_Chrace_&_OtherFactionLizardmen_&_Negative	wh2_main_sc_hef_high_elves
diplomacy_FactionGroup_HE_Prince2_Faction_Chrace_&_OtherFactionLizardmen_&_Positive	wh2_main_sc_hef_high_elves
diplomacy_FactionGroup_HE_Prince2_Faction_Chrace_&_OtherFactionSkaven	wh2_main_sc_hef_high_elves
diplomacy_FactionGroup_HE_Prince2_Faction_Chrace_&_OtherFactionSkaven_&_Negative	wh2_main_sc_hef_high_elves
diplomacy_FactionGroup_HE_Prince2_Faction_Chrace_&_OtherFactionSkaven_&_Positive	wh2_main_sc_hef_high_elves
diplomacy_FactionGroup_HE_Prince2_Faction_Chrace_&_OtherFactionVamp	wh2_main_sc_hef_high_elves
diplomacy_FactionGroup_HE_Prince2_Faction_Chrace_&_OtherFactionVamp_&_Negative	wh2_main_sc_hef_high_elves
diplomacy_FactionGroup_HE_Prince2_Faction_Chrace_&_OtherFactionVamp_&_Positive	wh2_main_sc_hef_high_elves
diplomacy_FactionGroup_HE_Prince2_Faction_Chrace_&_OtherFactionWoodElves	wh2_main_sc_hef_high_elves
diplomacy_FactionGroup_HE_Prince2_Faction_Chrace_&_OtherFactionWoodElves_&_Negative	wh2_main_sc_hef_high_elves
diplomacy_FactionGroup_HE_Prince2_Faction_Chrace_&_OtherFactionWoodElves_&_Positive	wh2_main_sc_hef_high_elves
diplomacy_FactionGroup_HE_Prince2_Faction_Chrace_&_Positive	wh2_main_sc_hef_high_elves
diplomacy_FactionGroup_HE_Prince2_Faction_CitadelofDusk	wh2_main_sc_hef_high_elves
diplomacy_FactionGroup_HE_Prince2_Faction_CitadelofDusk_&_Negative	wh2_main_sc_hef_high_elves
diplomacy_FactionGroup_HE_Prince2_Faction_CitadelofDusk_&_OtherFactionBeastmen	wh2_main_sc_hef_high_elves
diplomacy_FactionGroup_HE_Prince2_Faction_CitadelofDusk_&_OtherFactionBeastmen_&_Negative	wh2_main_sc_hef_high_elves
diplomacy_FactionGroup_HE_Prince2_Faction_CitadelofDusk_&_OtherFactionBeastmen_&_Positive	wh2_main_sc_hef_high_elves
diplomacy_FactionGroup_HE_Prince2_Faction_CitadelofDusk_&_OtherFactionBretonnia	wh2_main_sc_hef_high_elves
diplomacy_FactionGroup_HE_Prince2_Faction_CitadelofDusk_&_OtherFactionBretonnia_&_Negative	wh2_main_sc_hef_high_elves
diplomacy_FactionGroup_HE_Prince2_Faction_CitadelofDusk_&_OtherFactionBretonnia_&_Positive	wh2_main_sc_hef_high_elves
diplomacy_FactionGroup_HE_Prince2_Faction_CitadelofDusk_&_OtherFactionChaos	wh2_main_sc_hef_high_elves
diplomacy_FactionGroup_HE_Prince2_Faction_CitadelofDusk_&_OtherFactionChaos_&_Negative	wh2_main_sc_hef_high_elves
diplomacy_FactionGroup_HE_Prince2_Faction_CitadelofDusk_&_OtherFactionChaos_&_Positive	wh2_main_sc_hef_high_elves
diplomacy_FactionGroup_HE_Prince2_Faction_CitadelofDusk_&_OtherFactionDarkElves	wh2_main_sc_hef_high_elves
diplomacy_FactionGroup_HE_Prince2_Faction_CitadelofDusk_&_OtherFactionDarkElves_&_Negative	wh2_main_sc_hef_high_elves
diplomacy_FactionGroup_HE_Prince2_Faction_CitadelofDusk_&_OtherFactionDarkElves_&_Positive	wh2_main_sc_hef_high_elves
diplomacy_FactionGroup_HE_Prince2_Faction_CitadelofDusk_&_OtherFactionDwarf	wh2_main_sc_hef_high_elves
diplomacy_FactionGroup_HE_Prince2_Faction_CitadelofDusk_&_OtherFactionDwarf_&_Negative	wh2_main_sc_hef_high_elves
diplomacy_FactionGroup_HE_Prince2_Faction_CitadelofDusk_&_OtherFactionDwarf_&_Positive	wh2_main_sc_hef_high_elves
diplomacy_FactionGroup_HE_Prince2_Faction_CitadelofDusk_&_OtherFactionEmpire	wh2_main_sc_hef_high_elves
diplomacy_FactionGroup_HE_Prince2_Faction_CitadelofDusk_&_OtherFactionEmpire_&_Negative	wh2_main_sc_hef_high_elves
diplomacy_FactionGroup_HE_Prince2_Faction_CitadelofDusk_&_OtherFactionEmpire_&_Positive	wh2_main_sc_hef_high_elves
diplomacy_FactionGroup_HE_Prince2_Faction_CitadelofDusk_&_OtherFactionGreenskin	wh2_main_sc_hef_high_elves
diplomacy_FactionGroup_HE_Prince2_Faction_CitadelofDusk_&_OtherFactionGreenskin_&_Negative	wh2_main_sc_hef_high_elves
diplomacy_FactionGroup_HE_Prince2_Faction_CitadelofDusk_&_OtherFactionGreenskin_&_Positive	wh2_main_sc_hef_high_elves
diplomacy_FactionGroup_HE_Prince2_Faction_CitadelofDusk_&_OtherFactionHighElves	wh2_main_sc_hef_high_elves
diplomacy_FactionGroup_HE_Prince2_Faction_CitadelofDusk_&_OtherFactionHighElves_&_Negative	wh2_main_sc_hef_high_elves
diplomacy_FactionGroup_HE_Prince2_Faction_CitadelofDusk_&_OtherFactionHighElves_&_Positive	wh2_main_sc_hef_high_elves
diplomacy_FactionGroup_HE_Prince2_Faction_CitadelofDusk_&_OtherFactionLizardmen	wh2_main_sc_hef_high_elves
diplomacy_FactionGroup_HE_Prince2_Faction_CitadelofDusk_&_OtherFactionLizardmen_&_Negative	wh2_main_sc_hef_high_elves
diplomacy_FactionGroup_HE_Prince2_Faction_CitadelofDusk_&_OtherFactionLizardmen_&_Positive	wh2_main_sc_hef_high_elves
diplomacy_FactionGroup_HE_Prince2_Faction_CitadelofDusk_&_OtherFactionSkaven	wh2_main_sc_hef_high_elves
diplomacy_FactionGroup_HE_Prince2_Faction_CitadelofDusk_&_OtherFactionSkaven_&_Negative	wh2_main_sc_hef_high_elves
diplomacy_FactionGroup_HE_Prince2_Faction_CitadelofDusk_&_OtherFactionSkaven_&_Positive	wh2_main_sc_hef_high_elves
diplomacy_FactionGroup_HE_Prince2_Faction_CitadelofDusk_&_OtherFactionVamp	wh2_main_sc_hef_high_elves
diplomacy_FactionGroup_HE_Prince2_Faction_CitadelofDusk_&_OtherFactionVamp_&_Negative	wh2_main_sc_hef_high_elves
diplomacy_FactionGroup_HE_Prince2_Faction_CitadelofDusk_&_OtherFactionVamp_&_Positive	wh2_main_sc_hef_high_elves
diplomacy_FactionGroup_HE_Prince2_Faction_CitadelofDusk_&_OtherFactionWoodElves	wh2_main_sc_hef_high_elves
diplomacy_FactionGroup_HE_Prince2_Faction_CitadelofDusk_&_OtherFactionWoodElves_&_Negative	wh2_main_sc_hef_high_elves
diplomacy_FactionGroup_HE_Prince2_Faction_CitadelofDusk_&_OtherFactionWoodElves_&_Positive	wh2_main_sc_hef_high_elves
diplomacy_FactionGroup_HE_Prince2_Faction_CitadelofDusk_&_Positive	wh2_main_sc_hef_high_elves
diplomacy_FactionGroup_HE_Prince2_Faction_Ellyrion	wh2_main_sc_hef_high_elves
diplomacy_FactionGroup_HE_Prince2_Faction_Ellyrion_&_Negative	wh2_main_sc_hef_high_elves
diplomacy_FactionGroup_HE_Prince2_Faction_Ellyrion_&_OtherFactionBeastmen	wh2_main_sc_hef_high_elves
diplomacy_FactionGroup_HE_Prince2_Faction_Ellyrion_&_OtherFactionBeastmen_&_Negative	wh2_main_sc_hef_high_elves
diplomacy_FactionGroup_HE_Prince2_Faction_Ellyrion_&_OtherFactionBeastmen_&_Positive	wh2_main_sc_hef_high_elves
diplomacy_FactionGroup_HE_Prince2_Faction_Ellyrion_&_OtherFactionBretonnia	wh2_main_sc_hef_high_elves
diplomacy_FactionGroup_HE_Prince2_Faction_Ellyrion_&_OtherFactionBretonnia_&_Negative	wh2_main_sc_hef_high_elves
diplomacy_FactionGroup_HE_Prince2_Faction_Ellyrion_&_OtherFactionBretonnia_&_Positive	wh2_main_sc_hef_high_elves
diplomacy_FactionGroup_HE_Prince2_Faction_Ellyrion_&_OtherFactionChaos	wh2_main_sc_hef_high_elves
diplomacy_FactionGroup_HE_Prince2_Faction_Ellyrion_&_OtherFactionChaos_&_Negative	wh2_main_sc_hef_high_elves
diplomacy_FactionGroup_HE_Prince2_Faction_Ellyrion_&_OtherFactionChaos_&_Positive	wh2_main_sc_hef_high_elves
diplomacy_FactionGroup_HE_Prince2_Faction_Ellyrion_&_OtherFactionDarkElves	wh2_main_sc_hef_high_elves
diplomacy_FactionGroup_HE_Prince2_Faction_Ellyrion_&_OtherFactionDarkElves_&_Negative	wh2_main_sc_hef_high_elves
diplomacy_FactionGroup_HE_Prince2_Faction_Ellyrion_&_OtherFactionDarkElves_&_Positive	wh2_main_sc_hef_high_elves
diplomacy_FactionGroup_HE_Prince2_Faction_Ellyrion_&_OtherFactionDwarf	wh2_main_sc_hef_high_elves
diplomacy_FactionGroup_HE_Prince2_Faction_Ellyrion_&_OtherFactionDwarf_&_Negative	wh2_main_sc_hef_high_elves
diplomacy_FactionGroup_HE_Prince2_Faction_Ellyrion_&_OtherFactionDwarf_&_Positive	wh2_main_sc_hef_high_elves
diplomacy_FactionGroup_HE_Prince2_Faction_Ellyrion_&_OtherFactionEmpire	wh2_main_sc_hef_high_elves
diplomacy_FactionGroup_HE_Prince2_Faction_Ellyrion_&_OtherFactionEmpire_&_Negative	wh2_main_sc_hef_high_elves
diplomacy_FactionGroup_HE_Prince2_Faction_Ellyrion_&_OtherFactionEmpire_&_Positive	wh2_main_sc_hef_high_elves
diplomacy_FactionGroup_HE_Prince2_Faction_Ellyrion_&_OtherFactionGreenskin	wh2_main_sc_hef_high_elves
diplomacy_FactionGroup_HE_Prince2_Faction_Ellyrion_&_OtherFactionGreenskin_&_Negative	wh2_main_sc_hef_high_elves
diplomacy_FactionGroup_HE_Prince2_Faction_Ellyrion_&_OtherFactionGreenskin_&_Positive	wh2_main_sc_hef_high_elves
diplomacy_FactionGroup_HE_Prince2_Faction_Ellyrion_&_OtherFactionHighElves	wh2_main_sc_hef_high_elves
diplomacy_FactionGroup_HE_Prince2_Faction_Ellyrion_&_OtherFactionHighElves_&_Negative	wh2_main_sc_hef_high_elves
diplomacy_FactionGroup_HE_Prince2_Faction_Ellyrion_&_OtherFactionHighElves_&_Positive	wh2_main_sc_hef_high_elves
diplomacy_FactionGroup_HE_Prince2_Faction_Ellyrion_&_OtherFactionLizardmen	wh2_main_sc_hef_high_elves
diplomacy_FactionGroup_HE_Prince2_Faction_Ellyrion_&_OtherFactionLizardmen_&_Negative	wh2_main_sc_hef_high_elves
diplomacy_FactionGroup_HE_Prince2_Faction_Ellyrion_&_OtherFactionLizardmen_&_Positive	wh2_main_sc_hef_high_elves
diplomacy_FactionGroup_HE_Prince2_Faction_Ellyrion_&_OtherFactionSkaven	wh2_main_sc_hef_high_elves
diplomacy_FactionGroup_HE_Prince2_Faction_Ellyrion_&_OtherFactionSkaven_&_Negative	wh2_main_sc_hef_high_elves
diplomacy_FactionGroup_HE_Prince2_Faction_Ellyrion_&_OtherFactionSkaven_&_Positive	wh2_main_sc_hef_high_elves
diplomacy_FactionGroup_HE_Prince2_Faction_Ellyrion_&_OtherFactionVamp	wh2_main_sc_hef_high_elves
diplomacy_FactionGroup_HE_Prince2_Faction_Ellyrion_&_OtherFactionVamp_&_Negative	wh2_main_sc_hef_high_elves
diplomacy_FactionGroup_HE_Prince2_Faction_Ellyrion_&_OtherFactionVamp_&_Positive	wh2_main_sc_hef_high_elves
diplomacy_FactionGroup_HE_Prince2_Faction_Ellyrion_&_OtherFactionWoodElves	wh2_main_sc_hef_high_elves
diplomacy_FactionGroup_HE_Prince2_Faction_Ellyrion_&_OtherFactionWoodElves_&_Negative	wh2_main_sc_hef_high_elves
diplomacy_FactionGroup_HE_Prince2_Faction_Ellyrion_&_OtherFactionWoodElves_&_Positive	wh2_main_sc_hef_high_elves
diplomacy_FactionGroup_HE_Prince2_Faction_Ellyrion_&_Positive	wh2_main_sc_hef_high_elves
diplomacy_FactionGroup_HE_Princess_Faction_Cothique	wh2_main_sc_hef_high_elves
diplomacy_FactionGroup_HE_Princess_Faction_Cothique_&_Negative	wh2_main_sc_hef_high_elves
diplomacy_FactionGroup_HE_Princess_Faction_Cothique_&_OtherFactionBeastmen	wh2_main_sc_hef_high_elves
diplomacy_FactionGroup_HE_Princess_Faction_Cothique_&_OtherFactionBeastmen_&_Negative	wh2_main_sc_hef_high_elves
diplomacy_FactionGroup_HE_Princess_Faction_Cothique_&_OtherFactionBeastmen_&_Positive	wh2_main_sc_hef_high_elves
diplomacy_FactionGroup_HE_Princess_Faction_Cothique_&_OtherFactionBretonnia	wh2_main_sc_hef_high_elves
diplomacy_FactionGroup_HE_Princess_Faction_Cothique_&_OtherFactionBretonnia_&_Negative	wh2_main_sc_hef_high_elves
diplomacy_FactionGroup_HE_Princess_Faction_Cothique_&_OtherFactionBretonnia_&_Positive	wh2_main_sc_hef_high_elves
diplomacy_FactionGroup_HE_Princess_Faction_Cothique_&_OtherFactionChaos	wh2_main_sc_hef_high_elves
diplomacy_FactionGroup_HE_Princess_Faction_Cothique_&_OtherFactionChaos_&_Negative	wh2_main_sc_hef_high_elves
diplomacy_FactionGroup_HE_Princess_Faction_Cothique_&_OtherFactionChaos_&_Positive	wh2_main_sc_hef_high_elves
diplomacy_FactionGroup_HE_Princess_Faction_Cothique_&_OtherFactionDarkElves	wh2_main_sc_hef_high_elves
diplomacy_FactionGroup_HE_Princess_Faction_Cothique_&_OtherFactionDarkElves_&_Negative	wh2_main_sc_hef_high_elves
diplomacy_FactionGroup_HE_Princess_Faction_Cothique_&_OtherFactionDarkElves_&_Positive	wh2_main_sc_hef_high_elves
diplomacy_FactionGroup_HE_Princess_Faction_Cothique_&_OtherFactionDwarf	wh2_main_sc_hef_high_elves
diplomacy_FactionGroup_HE_Princess_Faction_Cothique_&_OtherFactionDwarf_&_Negative	wh2_main_sc_hef_high_elves
diplomacy_FactionGroup_HE_Princess_Faction_Cothique_&_OtherFactionDwarf_&_Positive	wh2_main_sc_hef_high_elves
diplomacy_FactionGroup_HE_Princess_Faction_Cothique_&_OtherFactionEmpire	wh2_main_sc_hef_high_elves
diplomacy_FactionGroup_HE_Princess_Faction_Cothique_&_OtherFactionEmpire_&_Negative	wh2_main_sc_hef_high_elves
diplomacy_FactionGroup_HE_Princess_Faction_Cothique_&_OtherFactionEmpire_&_Positive	wh2_main_sc_hef_high_elves
diplomacy_FactionGroup_HE_Princess_Faction_Cothique_&_OtherFactionGreenskin	wh2_main_sc_hef_high_elves
diplomacy_FactionGroup_HE_Princess_Faction_Cothique_&_OtherFactionGreenskin_&_Negative	wh2_main_sc_hef_high_elves
diplomacy_FactionGroup_HE_Princess_Faction_Cothique_&_OtherFactionGreenskin_&_Positive	wh2_main_sc_hef_high_elves
diplomacy_FactionGroup_HE_Princess_Faction_Cothique_&_OtherFactionHighElves	wh2_main_sc_hef_high_elves
diplomacy_FactionGroup_HE_Princess_Faction_Cothique_&_OtherFactionHighElves_&_Negative	wh2_main_sc_hef_high_elves
diplomacy_FactionGroup_HE_Princess_Faction_Cothique_&_OtherFactionHighElves_&_Positive	wh2_main_sc_hef_high_elves
diplomacy_FactionGroup_HE_Princess_Faction_Cothique_&_OtherFactionLizardmen	wh2_main_sc_hef_high_elves
diplomacy_FactionGroup_HE_Princess_Faction_Cothique_&_OtherFactionLizardmen_&_Negative	wh2_main_sc_hef_high_elves
diplomacy_FactionGroup_HE_Princess_Faction_Cothique_&_OtherFactionLizardmen_&_Positive	wh2_main_sc_hef_high_elves
diplomacy_FactionGroup_HE_Princess_Faction_Cothique_&_OtherFactionSkaven	wh2_main_sc_hef_high_elves
diplomacy_FactionGroup_HE_Princess_Faction_Cothique_&_OtherFactionSkaven_&_Negative	wh2_main_sc_hef_high_elves
diplomacy_FactionGroup_HE_Princess_Faction_Cothique_&_OtherFactionSkaven_&_Positive	wh2_main_sc_hef_high_elves
diplomacy_FactionGroup_HE_Princess_Faction_Cothique_&_OtherFactionVamp	wh2_main_sc_hef_high_elves
diplomacy_FactionGroup_HE_Princess_Faction_Cothique_&_OtherFactionVamp_&_Negative	wh2_main_sc_hef_high_elves
diplomacy_FactionGroup_HE_Princess_Faction_Cothique_&_OtherFactionVamp_&_Positive	wh2_main_sc_hef_high_elves
diplomacy_FactionGroup_HE_Princess_Faction_Cothique_&_OtherFactionWoodElves	wh2_main_sc_hef_high_elves
diplomacy_FactionGroup_HE_Princess_Faction_Cothique_&_OtherFactionWoodElves_&_Negative	wh2_main_sc_hef_high_elves
diplomacy_FactionGroup_HE_Princess_Faction_Cothique_&_OtherFactionWoodElves_&_Positive	wh2_main_sc_hef_high_elves
diplomacy_FactionGroup_HE_Princess_Faction_Cothique_&_Positive	wh2_main_sc_hef_high_elves
diplomacy_FactionGroup_HE_Princess_Faction_Nagarythe	wh2_main_sc_hef_high_elves
diplomacy_FactionGroup_HE_Princess_Faction_Nagarythe_&_Negative	wh2_main_sc_hef_high_elves
diplomacy_FactionGroup_HE_Princess_Faction_Nagarythe_&_OtherFactionBeastmen	wh2_main_sc_hef_high_elves
diplomacy_FactionGroup_HE_Princess_Faction_Nagarythe_&_OtherFactionBeastmen_&_Negative	wh2_main_sc_hef_high_elves
diplomacy_FactionGroup_HE_Princess_Faction_Nagarythe_&_OtherFactionBeastmen_&_Positive	wh2_main_sc_hef_high_elves
diplomacy_FactionGroup_HE_Princess_Faction_Nagarythe_&_OtherFactionBretonnia	wh2_main_sc_hef_high_elves
diplomacy_FactionGroup_HE_Princess_Faction_Nagarythe_&_OtherFactionBretonnia_&_Negative	wh2_main_sc_hef_high_elves
diplomacy_FactionGroup_HE_Princess_Faction_Nagarythe_&_OtherFactionBretonnia_&_Positive	wh2_main_sc_hef_high_elves
diplomacy_FactionGroup_HE_Princess_Faction_Nagarythe_&_OtherFactionChaos	wh2_main_sc_hef_high_elves
diplomacy_FactionGroup_HE_Princess_Faction_Nagarythe_&_OtherFactionChaos_&_Negative	wh2_main_sc_hef_high_elves
diplomacy_FactionGroup_HE_Princess_Faction_Nagarythe_&_OtherFactionChaos_&_Positive	wh2_main_sc_hef_high_elves
diplomacy_FactionGroup_HE_Princess_Faction_Nagarythe_&_OtherFactionDarkElves	wh2_main_sc_hef_high_elves
diplomacy_FactionGroup_HE_Princess_Faction_Nagarythe_&_OtherFactionDarkElves_&_Negative	wh2_main_sc_hef_high_elves
diplomacy_FactionGroup_HE_Princess_Faction_Nagarythe_&_OtherFactionDarkElves_&_Positive	wh2_main_sc_hef_high_elves
diplomacy_FactionGroup_HE_Princess_Faction_Nagarythe_&_OtherFactionDwarf	wh2_main_sc_hef_high_elves
diplomacy_FactionGroup_HE_Princess_Faction_Nagarythe_&_OtherFactionDwarf_&_Negative	wh2_main_sc_hef_high_elves
diplomacy_FactionGroup_HE_Princess_Faction_Nagarythe_&_OtherFactionDwarf_&_Positive	wh2_main_sc_hef_high_elves
diplomacy_FactionGroup_HE_Princess_Faction_Nagarythe_&_OtherFactionEmpire	wh2_main_sc_hef_high_elves
diplomacy_FactionGroup_HE_Princess_Faction_Nagarythe_&_OtherFactionEmpire_&_Negative	wh2_main_sc_hef_high_elves
diplomacy_FactionGroup_HE_Princess_Faction_Nagarythe_&_OtherFactionEmpire_&_Positive	wh2_main_sc_hef_high_elves
diplomacy_FactionGroup_HE_Princess_Faction_Nagarythe_&_OtherFactionGreenskin	wh2_main_sc_hef_high_elves
diplomacy_FactionGroup_HE_Princess_Faction_Nagarythe_&_OtherFactionGreenskin_&_Negative	wh2_main_sc_hef_high_elves
diplomacy_FactionGroup_HE_Princess_Faction_Nagarythe_&_OtherFactionGreenskin_&_Positive	wh2_main_sc_hef_high_elves
diplomacy_FactionGroup_HE_Princess_Faction_Nagarythe_&_OtherFactionHighElves	wh2_main_sc_hef_high_elves
diplomacy_FactionGroup_HE_Princess_Faction_Nagarythe_&_OtherFactionHighElves_&_Negative	wh2_main_sc_hef_high_elves
diplomacy_FactionGroup_HE_Princess_Faction_Nagarythe_&_OtherFactionHighElves_&_Positive	wh2_main_sc_hef_high_elves
diplomacy_FactionGroup_HE_Princess_Faction_Nagarythe_&_OtherFactionLizardmen	wh2_main_sc_hef_high_elves
diplomacy_FactionGroup_HE_Princess_Faction_Nagarythe_&_OtherFactionLizardmen_&_Negative	wh2_main_sc_hef_high_elves
diplomacy_FactionGroup_HE_Princess_Faction_Nagarythe_&_OtherFactionLizardmen_&_Positive	wh2_main_sc_hef_high_elves
diplomacy_FactionGroup_HE_Princess_Faction_Nagarythe_&_OtherFactionSkaven	wh2_main_sc_hef_high_elves
diplomacy_FactionGroup_HE_Princess_Faction_Nagarythe_&_OtherFactionSkaven_&_Negative	wh2_main_sc_hef_high_elves
diplomacy_FactionGroup_HE_Princess_Faction_Nagarythe_&_OtherFactionSkaven_&_Positive	wh2_main_sc_hef_high_elves
diplomacy_FactionGroup_HE_Princess_Faction_Nagarythe_&_OtherFactionVamp	wh2_main_sc_hef_high_elves
diplomacy_FactionGroup_HE_Princess_Faction_Nagarythe_&_OtherFactionVamp_&_Negative	wh2_main_sc_hef_high_elves
diplomacy_FactionGroup_HE_Princess_Faction_Nagarythe_&_OtherFactionVamp_&_Positive	wh2_main_sc_hef_high_elves
diplomacy_FactionGroup_HE_Princess_Faction_Nagarythe_&_OtherFactionWoodElves	wh2_main_sc_hef_high_elves
diplomacy_FactionGroup_HE_Princess_Faction_Nagarythe_&_OtherFactionWoodElves_&_Negative	wh2_main_sc_hef_high_elves
diplomacy_FactionGroup_HE_Princess_Faction_Nagarythe_&_OtherFactionWoodElves_&_Positive	wh2_main_sc_hef_high_elves
diplomacy_FactionGroup_HE_Princess_Faction_Nagarythe_&_Positive	wh2_main_sc_hef_high_elves
diplomacy_FactionGroup_HE_Princess_Faction_Saphery	wh2_main_sc_hef_high_elves
diplomacy_FactionGroup_HE_Princess_Faction_Saphery_&_Negative	wh2_main_sc_hef_high_elves
diplomacy_FactionGroup_HE_Princess_Faction_Saphery_&_OtherFactionBeastmen	wh2_main_sc_hef_high_elves
diplomacy_FactionGroup_HE_Princess_Faction_Saphery_&_OtherFactionBeastmen_&_Negative	wh2_main_sc_hef_high_elves
diplomacy_FactionGroup_HE_Princess_Faction_Saphery_&_OtherFactionBeastmen_&_Positive	wh2_main_sc_hef_high_elves
diplomacy_FactionGroup_HE_Princess_Faction_Saphery_&_OtherFactionBretonnia	wh2_main_sc_hef_high_elves
diplomacy_FactionGroup_HE_Princess_Faction_Saphery_&_OtherFactionBretonnia_&_Negative	wh2_main_sc_hef_high_elves
diplomacy_FactionGroup_HE_Princess_Faction_Saphery_&_OtherFactionBretonnia_&_Positive	wh2_main_sc_hef_high_elves
diplomacy_FactionGroup_HE_Princess_Faction_Saphery_&_OtherFactionChaos	wh2_main_sc_hef_high_elves
diplomacy_FactionGroup_HE_Princess_Faction_Saphery_&_OtherFactionChaos_&_Negative	wh2_main_sc_hef_high_elves
diplomacy_FactionGroup_HE_Princess_Faction_Saphery_&_OtherFactionChaos_&_Positive	wh2_main_sc_hef_high_elves
diplomacy_FactionGroup_HE_Princess_Faction_Saphery_&_OtherFactionDarkElves	wh2_main_sc_hef_high_elves
diplomacy_FactionGroup_HE_Princess_Faction_Saphery_&_OtherFactionDarkElves_&_Negative	wh2_main_sc_hef_high_elves
diplomacy_FactionGroup_HE_Princess_Faction_Saphery_&_OtherFactionDarkElves_&_Positive	wh2_main_sc_hef_high_elves
diplomacy_FactionGroup_HE_Princess_Faction_Saphery_&_OtherFactionDwarf	wh2_main_sc_hef_high_elves
diplomacy_FactionGroup_HE_Princess_Faction_Saphery_&_OtherFactionDwarf_&_Negative	wh2_main_sc_hef_high_elves
diplomacy_FactionGroup_HE_Princess_Faction_Saphery_&_OtherFactionDwarf_&_Positive	wh2_main_sc_hef_high_elves
diplomacy_FactionGroup_HE_Princess_Faction_Saphery_&_OtherFactionEmpire	wh2_main_sc_hef_high_elves
diplomacy_FactionGroup_HE_Princess_Faction_Saphery_&_OtherFactionEmpire_&_Negative	wh2_main_sc_hef_high_elves
diplomacy_FactionGroup_HE_Princess_Faction_Saphery_&_OtherFactionEmpire_&_Positive	wh2_main_sc_hef_high_elves
diplomacy_FactionGroup_HE_Princess_Faction_Saphery_&_OtherFactionGreenskin	wh2_main_sc_hef_high_elves
diplomacy_FactionGroup_HE_Princess_Faction_Saphery_&_OtherFactionGreenskin_&_Negative	wh2_main_sc_hef_high_elves
diplomacy_FactionGroup_HE_Princess_Faction_Saphery_&_OtherFactionGreenskin_&_Positive	wh2_main_sc_hef_high_elves
diplomacy_FactionGroup_HE_Princess_Faction_Saphery_&_OtherFactionHighElves	wh2_main_sc_hef_high_elves
diplomacy_FactionGroup_HE_Princess_Faction_Saphery_&_OtherFactionHighElves_&_Negative	wh2_main_sc_hef_high_elves
diplomacy_FactionGroup_HE_Princess_Faction_Saphery_&_OtherFactionHighElves_&_Positive	wh2_main_sc_hef_high_elves
diplomacy_FactionGroup_HE_Princess_Faction_Saphery_&_OtherFactionLizardmen	wh2_main_sc_hef_high_elves
diplomacy_FactionGroup_HE_Princess_Faction_Saphery_&_OtherFactionLizardmen_&_Negative	wh2_main_sc_hef_high_elves
diplomacy_FactionGroup_HE_Princess_Faction_Saphery_&_OtherFactionLizardmen_&_Positive	wh2_main_sc_hef_high_elves
diplomacy_FactionGroup_HE_Princess_Faction_Saphery_&_OtherFactionSkaven	wh2_main_sc_hef_high_elves
diplomacy_FactionGroup_HE_Princess_Faction_Saphery_&_OtherFactionSkaven_&_Negative	wh2_main_sc_hef_high_elves
diplomacy_FactionGroup_HE_Princess_Faction_Saphery_&_OtherFactionSkaven_&_Positive	wh2_main_sc_hef_high_elves
diplomacy_FactionGroup_HE_Princess_Faction_Saphery_&_OtherFactionVamp	wh2_main_sc_hef_high_elves
diplomacy_FactionGroup_HE_Princess_Faction_Saphery_&_OtherFactionVamp_&_Negative	wh2_main_sc_hef_high_elves
diplomacy_FactionGroup_HE_Princess_Faction_Saphery_&_OtherFactionVamp_&_Positive	wh2_main_sc_hef_high_elves
diplomacy_FactionGroup_HE_Princess_Faction_Saphery_&_OtherFactionWoodElves	wh2_main_sc_hef_high_elves
diplomacy_FactionGroup_HE_Princess_Faction_Saphery_&_OtherFactionWoodElves_&_Negative	wh2_main_sc_hef_high_elves
diplomacy_FactionGroup_HE_Princess_Faction_Saphery_&_OtherFactionWoodElves_&_Positive	wh2_main_sc_hef_high_elves
diplomacy_FactionGroup_HE_Princess_Faction_Saphery_&_Positive	wh2_main_sc_hef_high_elves
diplomacy_FactionGroup_HE_Princess_Faction_Tiranoc	wh2_main_sc_hef_high_elves
diplomacy_FactionGroup_HE_Princess_Faction_Tiranoc_&_Negative	wh2_main_sc_hef_high_elves
diplomacy_FactionGroup_HE_Princess_Faction_Tiranoc_&_OtherFactionBeastmen	wh2_main_sc_hef_high_elves
diplomacy_FactionGroup_HE_Princess_Faction_Tiranoc_&_OtherFactionBeastmen_&_Negative	wh2_main_sc_hef_high_elves
diplomacy_FactionGroup_HE_Princess_Faction_Tiranoc_&_OtherFactionBeastmen_&_Positive	wh2_main_sc_hef_high_elves
diplomacy_FactionGroup_HE_Princess_Faction_Tiranoc_&_OtherFactionBretonnia	wh2_main_sc_hef_high_elves
diplomacy_FactionGroup_HE_Princess_Faction_Tiranoc_&_OtherFactionBretonnia_&_Negative	wh2_main_sc_hef_high_elves
diplomacy_FactionGroup_HE_Princess_Faction_Tiranoc_&_OtherFactionBretonnia_&_Positive	wh2_main_sc_hef_high_elves
diplomacy_FactionGroup_HE_Princess_Faction_Tiranoc_&_OtherFactionChaos	wh2_main_sc_hef_high_elves
diplomacy_FactionGroup_HE_Princess_Faction_Tiranoc_&_OtherFactionChaos_&_Negative	wh2_main_sc_hef_high_elves
diplomacy_FactionGroup_HE_Princess_Faction_Tiranoc_&_OtherFactionChaos_&_Positive	wh2_main_sc_hef_high_elves
diplomacy_FactionGroup_HE_Princess_Faction_Tiranoc_&_OtherFactionDarkElves	wh2_main_sc_hef_high_elves
diplomacy_FactionGroup_HE_Princess_Faction_Tiranoc_&_OtherFactionDarkElves_&_Negative	wh2_main_sc_hef_high_elves
diplomacy_FactionGroup_HE_Princess_Faction_Tiranoc_&_OtherFactionDarkElves_&_Positive	wh2_main_sc_hef_high_elves
diplomacy_FactionGroup_HE_Princess_Faction_Tiranoc_&_OtherFactionDwarf	wh2_main_sc_hef_high_elves
diplomacy_FactionGroup_HE_Princess_Faction_Tiranoc_&_OtherFactionDwarf_&_Negative	wh2_main_sc_hef_high_elves
diplomacy_FactionGroup_HE_Princess_Faction_Tiranoc_&_OtherFactionDwarf_&_Positive	wh2_main_sc_hef_high_elves
diplomacy_FactionGroup_HE_Princess_Faction_Tiranoc_&_OtherFactionEmpire	wh2_main_sc_hef_high_elves
diplomacy_FactionGroup_HE_Princess_Faction_Tiranoc_&_OtherFactionEmpire_&_Negative	wh2_main_sc_hef_high_elves
diplomacy_FactionGroup_HE_Princess_Faction_Tiranoc_&_OtherFactionEmpire_&_Positive	wh2_main_sc_hef_high_elves
diplomacy_FactionGroup_HE_Princess_Faction_Tiranoc_&_OtherFactionGreenskin	wh2_main_sc_hef_high_elves
diplomacy_FactionGroup_HE_Princess_Faction_Tiranoc_&_OtherFactionGreenskin_&_Negative	wh2_main_sc_hef_high_elves
diplomacy_FactionGroup_HE_Princess_Faction_Tiranoc_&_OtherFactionGreenskin_&_Positive	wh2_main_sc_hef_high_elves
diplomacy_FactionGroup_HE_Princess_Faction_Tiranoc_&_OtherFactionHighElves	wh2_main_sc_hef_high_elves
diplomacy_FactionGroup_HE_Princess_Faction_Tiranoc_&_OtherFactionHighElves_&_Negative	wh2_main_sc_hef_high_elves
diplomacy_FactionGroup_HE_Princess_Faction_Tiranoc_&_OtherFactionHighElves_&_Positive	wh2_main_sc_hef_high_elves
diplomacy_FactionGroup_HE_Princess_Faction_Tiranoc_&_OtherFactionLizardmen	wh2_main_sc_hef_high_elves
diplomacy_FactionGroup_HE_Princess_Faction_Tiranoc_&_OtherFactionLizardmen_&_Negative	wh2_main_sc_hef_high_elves
diplomacy_FactionGroup_HE_Princess_Faction_Tiranoc_&_OtherFactionLizardmen_&_Positive	wh2_main_sc_hef_high_elves
diplomacy_FactionGroup_HE_Princess_Faction_Tiranoc_&_OtherFactionSkaven	wh2_main_sc_hef_high_elves
diplomacy_FactionGroup_HE_Princess_Faction_Tiranoc_&_OtherFactionSkaven_&_Negative	wh2_main_sc_hef_high_elves
diplomacy_FactionGroup_HE_Princess_Faction_Tiranoc_&_OtherFactionSkaven_&_Positive	wh2_main_sc_hef_high_elves
diplomacy_FactionGroup_HE_Princess_Faction_Tiranoc_&_OtherFactionVamp	wh2_main_sc_hef_high_elves
diplomacy_FactionGroup_HE_Princess_Faction_Tiranoc_&_OtherFactionVamp_&_Negative	wh2_main_sc_hef_high_elves
diplomacy_FactionGroup_HE_Princess_Faction_Tiranoc_&_OtherFactionVamp_&_Positive	wh2_main_sc_hef_high_elves
diplomacy_FactionGroup_HE_Princess_Faction_Tiranoc_&_OtherFactionWoodElves	wh2_main_sc_hef_high_elves
diplomacy_FactionGroup_HE_Princess_Faction_Tiranoc_&_OtherFactionWoodElves_&_Negative	wh2_main_sc_hef_high_elves
diplomacy_FactionGroup_HE_Princess_Faction_Tiranoc_&_OtherFactionWoodElves_&_Positive	wh2_main_sc_hef_high_elves
diplomacy_FactionGroup_HE_Princess_Faction_Tiranoc_&_Positive	wh2_main_sc_hef_high_elves
diplomacy_FactionGroup_LZD_Saurus1_Faction_Itza	wh2_main_sc_lzd_lizardmen
diplomacy_FactionGroup_LZD_Saurus1_Faction_Itza_&_Negative	wh2_main_sc_lzd_lizardmen
diplomacy_FactionGroup_LZD_Saurus1_Faction_Itza_&_OtherFactionBeastmen	wh2_main_sc_lzd_lizardmen
diplomacy_FactionGroup_LZD_Saurus1_Faction_Itza_&_OtherFactionBeastmen_&_Negative	wh2_main_sc_lzd_lizardmen
diplomacy_FactionGroup_LZD_Saurus1_Faction_Itza_&_OtherFactionBeastmen_&_Positive	wh2_main_sc_lzd_lizardmen
diplomacy_FactionGroup_LZD_Saurus1_Faction_Itza_&_OtherFactionBretonnia	wh2_main_sc_lzd_lizardmen
diplomacy_FactionGroup_LZD_Saurus1_Faction_Itza_&_OtherFactionBretonnia_&_Negative	wh2_main_sc_lzd_lizardmen
diplomacy_FactionGroup_LZD_Saurus1_Faction_Itza_&_OtherFactionBretonnia_&_Positive	wh2_main_sc_lzd_lizardmen
diplomacy_FactionGroup_LZD_Saurus1_Faction_Itza_&_OtherFactionChaos	wh2_main_sc_lzd_lizardmen
diplomacy_FactionGroup_LZD_Saurus1_Faction_Itza_&_OtherFactionChaos_&_Negative	wh2_main_sc_lzd_lizardmen
diplomacy_FactionGroup_LZD_Saurus1_Faction_Itza_&_OtherFactionChaos_&_Positive	wh2_main_sc_lzd_lizardmen
diplomacy_FactionGroup_LZD_Saurus1_Faction_Itza_&_OtherFactionDarkElves	wh2_main_sc_lzd_lizardmen
diplomacy_FactionGroup_LZD_Saurus1_Faction_Itza_&_OtherFactionDarkElves_&_Negative	wh2_main_sc_lzd_lizardmen
diplomacy_FactionGroup_LZD_Saurus1_Faction_Itza_&_OtherFactionDarkElves_&_Positive	wh2_main_sc_lzd_lizardmen
diplomacy_FactionGroup_LZD_Saurus1_Faction_Itza_&_OtherFactionDwarf	wh2_main_sc_lzd_lizardmen
diplomacy_FactionGroup_LZD_Saurus1_Faction_Itza_&_OtherFactionDwarf_&_Negative	wh2_main_sc_lzd_lizardmen
diplomacy_FactionGroup_LZD_Saurus1_Faction_Itza_&_OtherFactionDwarf_&_Positive	wh2_main_sc_lzd_lizardmen
diplomacy_FactionGroup_LZD_Saurus1_Faction_Itza_&_OtherFactionEmpire	wh2_main_sc_lzd_lizardmen
diplomacy_FactionGroup_LZD_Saurus1_Faction_Itza_&_OtherFactionEmpire_&_Negative	wh2_main_sc_lzd_lizardmen
diplomacy_FactionGroup_LZD_Saurus1_Faction_Itza_&_OtherFactionEmpire_&_Positive	wh2_main_sc_lzd_lizardmen
diplomacy_FactionGroup_LZD_Saurus1_Faction_Itza_&_OtherFactionGreenskin	wh2_main_sc_lzd_lizardmen
diplomacy_FactionGroup_LZD_Saurus1_Faction_Itza_&_OtherFactionGreenskin_&_Negative	wh2_main_sc_lzd_lizardmen
diplomacy_FactionGroup_LZD_Saurus1_Faction_Itza_&_OtherFactionGreenskin_&_Positive	wh2_main_sc_lzd_lizardmen
diplomacy_FactionGroup_LZD_Saurus1_Faction_Itza_&_OtherFactionHighElves	wh2_main_sc_lzd_lizardmen
diplomacy_FactionGroup_LZD_Saurus1_Faction_Itza_&_OtherFactionHighElves_&_Negative	wh2_main_sc_lzd_lizardmen
diplomacy_FactionGroup_LZD_Saurus1_Faction_Itza_&_OtherFactionHighElves_&_Positive	wh2_main_sc_lzd_lizardmen
diplomacy_FactionGroup_LZD_Saurus1_Faction_Itza_&_OtherFactionLizardmen	wh2_main_sc_lzd_lizardmen
diplomacy_FactionGroup_LZD_Saurus1_Faction_Itza_&_OtherFactionLizardmen_&_Negative	wh2_main_sc_lzd_lizardmen
diplomacy_FactionGroup_LZD_Saurus1_Faction_Itza_&_OtherFactionLizardmen_&_Positive	wh2_main_sc_lzd_lizardmen
diplomacy_FactionGroup_LZD_Saurus1_Faction_Itza_&_OtherFactionSkaven	wh2_main_sc_lzd_lizardmen
diplomacy_FactionGroup_LZD_Saurus1_Faction_Itza_&_OtherFactionSkaven_&_Negative	wh2_main_sc_lzd_lizardmen
diplomacy_FactionGroup_LZD_Saurus1_Faction_Itza_&_OtherFactionSkaven_&_Positive	wh2_main_sc_lzd_lizardmen
diplomacy_FactionGroup_LZD_Saurus1_Faction_Itza_&_OtherFactionVamp	wh2_main_sc_lzd_lizardmen
diplomacy_FactionGroup_LZD_Saurus1_Faction_Itza_&_OtherFactionVamp_&_Negative	wh2_main_sc_lzd_lizardmen
diplomacy_FactionGroup_LZD_Saurus1_Faction_Itza_&_OtherFactionVamp_&_Positive	wh2_main_sc_lzd_lizardmen
diplomacy_FactionGroup_LZD_Saurus1_Faction_Itza_&_OtherFactionWoodElves	wh2_main_sc_lzd_lizardmen
diplomacy_FactionGroup_LZD_Saurus1_Faction_Itza_&_OtherFactionWoodElves_&_Negative	wh2_main_sc_lzd_lizardmen
diplomacy_FactionGroup_LZD_Saurus1_Faction_Itza_&_OtherFactionWoodElves_&_Positive	wh2_main_sc_lzd_lizardmen
diplomacy_FactionGroup_LZD_Saurus1_Faction_Itza_&_Positive	wh2_main_sc_lzd_lizardmen
diplomacy_FactionGroup_LZD_Saurus1_Faction_SouthernSentinels	wh2_main_sc_lzd_lizardmen
diplomacy_FactionGroup_LZD_Saurus1_Faction_SouthernSentinels_&_Negative	wh2_main_sc_lzd_lizardmen
diplomacy_FactionGroup_LZD_Saurus1_Faction_SouthernSentinels_&_OtherFactionBeastmen	wh2_main_sc_lzd_lizardmen
diplomacy_FactionGroup_LZD_Saurus1_Faction_SouthernSentinels_&_OtherFactionBeastmen_&_Negative	wh2_main_sc_lzd_lizardmen
diplomacy_FactionGroup_LZD_Saurus1_Faction_SouthernSentinels_&_OtherFactionBeastmen_&_Positive	wh2_main_sc_lzd_lizardmen
diplomacy_FactionGroup_LZD_Saurus1_Faction_SouthernSentinels_&_OtherFactionBretonnia	wh2_main_sc_lzd_lizardmen
diplomacy_FactionGroup_LZD_Saurus1_Faction_SouthernSentinels_&_OtherFactionBretonnia_&_Negative	wh2_main_sc_lzd_lizardmen
diplomacy_FactionGroup_LZD_Saurus1_Faction_SouthernSentinels_&_OtherFactionBretonnia_&_Positive	wh2_main_sc_lzd_lizardmen
diplomacy_FactionGroup_LZD_Saurus1_Faction_SouthernSentinels_&_OtherFactionChaos	wh2_main_sc_lzd_lizardmen
diplomacy_FactionGroup_LZD_Saurus1_Faction_SouthernSentinels_&_OtherFactionChaos_&_Negative	wh2_main_sc_lzd_lizardmen
diplomacy_FactionGroup_LZD_Saurus1_Faction_SouthernSentinels_&_OtherFactionChaos_&_Positive	wh2_main_sc_lzd_lizardmen
diplomacy_FactionGroup_LZD_Saurus1_Faction_SouthernSentinels_&_OtherFactionDarkElves	wh2_main_sc_lzd_lizardmen
diplomacy_FactionGroup_LZD_Saurus1_Faction_SouthernSentinels_&_OtherFactionDarkElves_&_Negative	wh2_main_sc_lzd_lizardmen
diplomacy_FactionGroup_LZD_Saurus1_Faction_SouthernSentinels_&_OtherFactionDarkElves_&_Positive	wh2_main_sc_lzd_lizardmen
diplomacy_FactionGroup_LZD_Saurus1_Faction_SouthernSentinels_&_OtherFactionDwarf	wh2_main_sc_lzd_lizardmen
diplomacy_FactionGroup_LZD_Saurus1_Faction_SouthernSentinels_&_OtherFactionDwarf_&_Negative	wh2_main_sc_lzd_lizardmen
diplomacy_FactionGroup_LZD_Saurus1_Faction_SouthernSentinels_&_OtherFactionDwarf_&_Positive	wh2_main_sc_lzd_lizardmen
diplomacy_FactionGroup_LZD_Saurus1_Faction_SouthernSentinels_&_OtherFactionEmpire	wh2_main_sc_lzd_lizardmen
diplomacy_FactionGroup_LZD_Saurus1_Faction_SouthernSentinels_&_OtherFactionEmpire_&_Negative	wh2_main_sc_lzd_lizardmen
diplomacy_FactionGroup_LZD_Saurus1_Faction_SouthernSentinels_&_OtherFactionEmpire_&_Positive	wh2_main_sc_lzd_lizardmen
diplomacy_FactionGroup_LZD_Saurus1_Faction_SouthernSentinels_&_OtherFactionGreenskin	wh2_main_sc_lzd_lizardmen
diplomacy_FactionGroup_LZD_Saurus1_Faction_SouthernSentinels_&_OtherFactionGreenskin_&_Negative	wh2_main_sc_lzd_lizardmen
diplomacy_FactionGroup_LZD_Saurus1_Faction_SouthernSentinels_&_OtherFactionGreenskin_&_Positive	wh2_main_sc_lzd_lizardmen
diplomacy_FactionGroup_LZD_Saurus1_Faction_SouthernSentinels_&_OtherFactionHighElves	wh2_main_sc_lzd_lizardmen
diplomacy_FactionGroup_LZD_Saurus1_Faction_SouthernSentinels_&_OtherFactionHighElves_&_Negative	wh2_main_sc_lzd_lizardmen
diplomacy_FactionGroup_LZD_Saurus1_Faction_SouthernSentinels_&_OtherFactionHighElves_&_Positive	wh2_main_sc_lzd_lizardmen
diplomacy_FactionGroup_LZD_Saurus1_Faction_SouthernSentinels_&_OtherFactionLizardmen	wh2_main_sc_lzd_lizardmen
diplomacy_FactionGroup_LZD_Saurus1_Faction_SouthernSentinels_&_OtherFactionLizardmen_&_Negative	wh2_main_sc_lzd_lizardmen
diplomacy_FactionGroup_LZD_Saurus1_Faction_SouthernSentinels_&_OtherFactionLizardmen_&_Positive	wh2_main_sc_lzd_lizardmen
diplomacy_FactionGroup_LZD_Saurus1_Faction_SouthernSentinels_&_OtherFactionSkaven	wh2_main_sc_lzd_lizardmen
diplomacy_FactionGroup_LZD_Saurus1_Faction_SouthernSentinels_&_OtherFactionSkaven_&_Negative	wh2_main_sc_lzd_lizardmen
diplomacy_FactionGroup_LZD_Saurus1_Faction_SouthernSentinels_&_OtherFactionSkaven_&_Positive	wh2_main_sc_lzd_lizardmen
diplomacy_FactionGroup_LZD_Saurus1_Faction_SouthernSentinels_&_OtherFactionVamp	wh2_main_sc_lzd_lizardmen
diplomacy_FactionGroup_LZD_Saurus1_Faction_SouthernSentinels_&_OtherFactionVamp_&_Negative	wh2_main_sc_lzd_lizardmen
diplomacy_FactionGroup_LZD_Saurus1_Faction_SouthernSentinels_&_OtherFactionVamp_&_Positive	wh2_main_sc_lzd_lizardmen
diplomacy_FactionGroup_LZD_Saurus1_Faction_SouthernSentinels_&_OtherFactionWoodElves	wh2_main_sc_lzd_lizardmen
diplomacy_FactionGroup_LZD_Saurus1_Faction_SouthernSentinels_&_OtherFactionWoodElves_&_Negative	wh2_main_sc_lzd_lizardmen
diplomacy_FactionGroup_LZD_Saurus1_Faction_SouthernSentinels_&_OtherFactionWoodElves_&_Positive	wh2_main_sc_lzd_lizardmen
diplomacy_FactionGroup_LZD_Saurus1_Faction_SouthernSentinels_&_Positive	wh2_main_sc_lzd_lizardmen
diplomacy_FactionGroup_LZD_Saurus2_Faction_Tlaqua	wh2_main_sc_lzd_lizardmen
diplomacy_FactionGroup_LZD_Saurus2_Faction_Tlaqua_&_Negative	wh2_main_sc_lzd_lizardmen
diplomacy_FactionGroup_LZD_Saurus2_Faction_Tlaqua_&_OtherFactionBeastmen	wh2_main_sc_lzd_lizardmen
diplomacy_FactionGroup_LZD_Saurus2_Faction_Tlaqua_&_OtherFactionBeastmen_&_Negative	wh2_main_sc_lzd_lizardmen
diplomacy_FactionGroup_LZD_Saurus2_Faction_Tlaqua_&_OtherFactionBeastmen_&_Positive	wh2_main_sc_lzd_lizardmen
diplomacy_FactionGroup_LZD_Saurus2_Faction_Tlaqua_&_OtherFactionBretonnia	wh2_main_sc_lzd_lizardmen
diplomacy_FactionGroup_LZD_Saurus2_Faction_Tlaqua_&_OtherFactionBretonnia_&_Negative	wh2_main_sc_lzd_lizardmen
diplomacy_FactionGroup_LZD_Saurus2_Faction_Tlaqua_&_OtherFactionBretonnia_&_Positive	wh2_main_sc_lzd_lizardmen
diplomacy_FactionGroup_LZD_Saurus2_Faction_Tlaqua_&_OtherFactionChaos	wh2_main_sc_lzd_lizardmen
diplomacy_FactionGroup_LZD_Saurus2_Faction_Tlaqua_&_OtherFactionChaos_&_Negative	wh2_main_sc_lzd_lizardmen
diplomacy_FactionGroup_LZD_Saurus2_Faction_Tlaqua_&_OtherFactionChaos_&_Positive	wh2_main_sc_lzd_lizardmen
diplomacy_FactionGroup_LZD_Saurus2_Faction_Tlaqua_&_OtherFactionDarkElves	wh2_main_sc_lzd_lizardmen
diplomacy_FactionGroup_LZD_Saurus2_Faction_Tlaqua_&_OtherFactionDarkElves_&_Negative	wh2_main_sc_lzd_lizardmen
diplomacy_FactionGroup_LZD_Saurus2_Faction_Tlaqua_&_OtherFactionDarkElves_&_Positive	wh2_main_sc_lzd_lizardmen
diplomacy_FactionGroup_LZD_Saurus2_Faction_Tlaqua_&_OtherFactionDwarf	wh2_main_sc_lzd_lizardmen
diplomacy_FactionGroup_LZD_Saurus2_Faction_Tlaqua_&_OtherFactionDwarf_&_Negative	wh2_main_sc_lzd_lizardmen
diplomacy_FactionGroup_LZD_Saurus2_Faction_Tlaqua_&_OtherFactionDwarf_&_Positive	wh2_main_sc_lzd_lizardmen
diplomacy_FactionGroup_LZD_Saurus2_Faction_Tlaqua_&_OtherFactionEmpire	wh2_main_sc_lzd_lizardmen
diplomacy_FactionGroup_LZD_Saurus2_Faction_Tlaqua_&_OtherFactionEmpire_&_Negative	wh2_main_sc_lzd_lizardmen
diplomacy_FactionGroup_LZD_Saurus2_Faction_Tlaqua_&_OtherFactionEmpire_&_Positive	wh2_main_sc_lzd_lizardmen
diplomacy_FactionGroup_LZD_Saurus2_Faction_Tlaqua_&_OtherFactionGreenskin	wh2_main_sc_lzd_lizardmen
diplomacy_FactionGroup_LZD_Saurus2_Faction_Tlaqua_&_OtherFactionGreenskin_&_Negative	wh2_main_sc_lzd_lizardmen
diplomacy_FactionGroup_LZD_Saurus2_Faction_Tlaqua_&_OtherFactionGreenskin_&_Positive	wh2_main_sc_lzd_lizardmen
diplomacy_FactionGroup_LZD_Saurus2_Faction_Tlaqua_&_OtherFactionHighElves	wh2_main_sc_lzd_lizardmen
diplomacy_FactionGroup_LZD_Saurus2_Faction_Tlaqua_&_OtherFactionHighElves_&_Negative	wh2_main_sc_lzd_lizardmen
diplomacy_FactionGroup_LZD_Saurus2_Faction_Tlaqua_&_OtherFactionHighElves_&_Positive	wh2_main_sc_lzd_lizardmen
diplomacy_FactionGroup_LZD_Saurus2_Faction_Tlaqua_&_OtherFactionLizardmen	wh2_main_sc_lzd_lizardmen
diplomacy_FactionGroup_LZD_Saurus2_Faction_Tlaqua_&_OtherFactionLizardmen_&_Negative	wh2_main_sc_lzd_lizardmen
diplomacy_FactionGroup_LZD_Saurus2_Faction_Tlaqua_&_OtherFactionLizardmen_&_Positive	wh2_main_sc_lzd_lizardmen
diplomacy_FactionGroup_LZD_Saurus2_Faction_Tlaqua_&_OtherFactionSkaven	wh2_main_sc_lzd_lizardmen
diplomacy_FactionGroup_LZD_Saurus2_Faction_Tlaqua_&_OtherFactionSkaven_&_Negative	wh2_main_sc_lzd_lizardmen
diplomacy_FactionGroup_LZD_Saurus2_Faction_Tlaqua_&_OtherFactionSkaven_&_Positive	wh2_main_sc_lzd_lizardmen
diplomacy_FactionGroup_LZD_Saurus2_Faction_Tlaqua_&_OtherFactionVamp	wh2_main_sc_lzd_lizardmen
diplomacy_FactionGroup_LZD_Saurus2_Faction_Tlaqua_&_OtherFactionVamp_&_Negative	wh2_main_sc_lzd_lizardmen
diplomacy_FactionGroup_LZD_Saurus2_Faction_Tlaqua_&_OtherFactionVamp_&_Positive	wh2_main_sc_lzd_lizardmen
diplomacy_FactionGroup_LZD_Saurus2_Faction_Tlaqua_&_OtherFactionWoodElves	wh2_main_sc_lzd_lizardmen
diplomacy_FactionGroup_LZD_Saurus2_Faction_Tlaqua_&_OtherFactionWoodElves_&_Negative	wh2_main_sc_lzd_lizardmen
diplomacy_FactionGroup_LZD_Saurus2_Faction_Tlaqua_&_OtherFactionWoodElves_&_Positive	wh2_main_sc_lzd_lizardmen
diplomacy_FactionGroup_LZD_Saurus2_Faction_Tlaqua_&_Positive	wh2_main_sc_lzd_lizardmen
diplomacy_FactionGroup_LZD_Saurus2_Faction_Xlanhuapec	wh2_main_sc_lzd_lizardmen
diplomacy_FactionGroup_LZD_Saurus2_Faction_Xlanhuapec_&_Negative	wh2_main_sc_lzd_lizardmen
diplomacy_FactionGroup_LZD_Saurus2_Faction_Xlanhuapec_&_OtherFactionBeastmen	wh2_main_sc_lzd_lizardmen
diplomacy_FactionGroup_LZD_Saurus2_Faction_Xlanhuapec_&_OtherFactionBeastmen_&_Negative	wh2_main_sc_lzd_lizardmen
diplomacy_FactionGroup_LZD_Saurus2_Faction_Xlanhuapec_&_OtherFactionBeastmen_&_Positive	wh2_main_sc_lzd_lizardmen
diplomacy_FactionGroup_LZD_Saurus2_Faction_Xlanhuapec_&_OtherFactionBretonnia	wh2_main_sc_lzd_lizardmen
diplomacy_FactionGroup_LZD_Saurus2_Faction_Xlanhuapec_&_OtherFactionBretonnia_&_Negative	wh2_main_sc_lzd_lizardmen
diplomacy_FactionGroup_LZD_Saurus2_Faction_Xlanhuapec_&_OtherFactionBretonnia_&_Positive	wh2_main_sc_lzd_lizardmen
diplomacy_FactionGroup_LZD_Saurus2_Faction_Xlanhuapec_&_OtherFactionChaos	wh2_main_sc_lzd_lizardmen
diplomacy_FactionGroup_LZD_Saurus2_Faction_Xlanhuapec_&_OtherFactionChaos_&_Negative	wh2_main_sc_lzd_lizardmen
diplomacy_FactionGroup_LZD_Saurus2_Faction_Xlanhuapec_&_OtherFactionChaos_&_Positive	wh2_main_sc_lzd_lizardmen
diplomacy_FactionGroup_LZD_Saurus2_Faction_Xlanhuapec_&_OtherFactionDarkElves	wh2_main_sc_lzd_lizardmen
diplomacy_FactionGroup_LZD_Saurus2_Faction_Xlanhuapec_&_OtherFactionDarkElves_&_Negative	wh2_main_sc_lzd_lizardmen
diplomacy_FactionGroup_LZD_Saurus2_Faction_Xlanhuapec_&_OtherFactionDarkElves_&_Positive	wh2_main_sc_lzd_lizardmen
diplomacy_FactionGroup_LZD_Saurus2_Faction_Xlanhuapec_&_OtherFactionDwarf	wh2_main_sc_lzd_lizardmen
diplomacy_FactionGroup_LZD_Saurus2_Faction_Xlanhuapec_&_OtherFactionDwarf_&_Negative	wh2_main_sc_lzd_lizardmen
diplomacy_FactionGroup_LZD_Saurus2_Faction_Xlanhuapec_&_OtherFactionDwarf_&_Positive	wh2_main_sc_lzd_lizardmen
diplomacy_FactionGroup_LZD_Saurus2_Faction_Xlanhuapec_&_OtherFactionEmpire	wh2_main_sc_lzd_lizardmen
diplomacy_FactionGroup_LZD_Saurus2_Faction_Xlanhuapec_&_OtherFactionEmpire_&_Negative	wh2_main_sc_lzd_lizardmen
diplomacy_FactionGroup_LZD_Saurus2_Faction_Xlanhuapec_&_OtherFactionEmpire_&_Positive	wh2_main_sc_lzd_lizardmen
diplomacy_FactionGroup_LZD_Saurus2_Faction_Xlanhuapec_&_OtherFactionGreenskin	wh2_main_sc_lzd_lizardmen
diplomacy_FactionGroup_LZD_Saurus2_Faction_Xlanhuapec_&_OtherFactionGreenskin_&_Negative	wh2_main_sc_lzd_lizardmen
diplomacy_FactionGroup_LZD_Saurus2_Faction_Xlanhuapec_&_OtherFactionGreenskin_&_Positive	wh2_main_sc_lzd_lizardmen
diplomacy_FactionGroup_LZD_Saurus2_Faction_Xlanhuapec_&_OtherFactionHighElves	wh2_main_sc_lzd_lizardmen
diplomacy_FactionGroup_LZD_Saurus2_Faction_Xlanhuapec_&_OtherFactionHighElves_&_Negative	wh2_main_sc_lzd_lizardmen
diplomacy_FactionGroup_LZD_Saurus2_Faction_Xlanhuapec_&_OtherFactionHighElves_&_Positive	wh2_main_sc_lzd_lizardmen
diplomacy_FactionGroup_LZD_Saurus2_Faction_Xlanhuapec_&_OtherFactionLizardmen	wh2_main_sc_lzd_lizardmen
diplomacy_FactionGroup_LZD_Saurus2_Faction_Xlanhuapec_&_OtherFactionLizardmen_&_Negative	wh2_main_sc_lzd_lizardmen
diplomacy_FactionGroup_LZD_Saurus2_Faction_Xlanhuapec_&_OtherFactionLizardmen_&_Positive	wh2_main_sc_lzd_lizardmen
diplomacy_FactionGroup_LZD_Saurus2_Faction_Xlanhuapec_&_OtherFactionSkaven	wh2_main_sc_lzd_lizardmen
diplomacy_FactionGroup_LZD_Saurus2_Faction_Xlanhuapec_&_OtherFactionSkaven_&_Negative	wh2_main_sc_lzd_lizardmen
diplomacy_FactionGroup_LZD_Saurus2_Faction_Xlanhuapec_&_OtherFactionSkaven_&_Positive	wh2_main_sc_lzd_lizardmen
diplomacy_FactionGroup_LZD_Saurus2_Faction_Xlanhuapec_&_OtherFactionVamp	wh2_main_sc_lzd_lizardmen
diplomacy_FactionGroup_LZD_Saurus2_Faction_Xlanhuapec_&_OtherFactionVamp_&_Negative	wh2_main_sc_lzd_lizardmen
diplomacy_FactionGroup_LZD_Saurus2_Faction_Xlanhuapec_&_OtherFactionVamp_&_Positive	wh2_main_sc_lzd_lizardmen
diplomacy_FactionGroup_LZD_Saurus2_Faction_Xlanhuapec_&_OtherFactionWoodElves	wh2_main_sc_lzd_lizardmen
diplomacy_FactionGroup_LZD_Saurus2_Faction_Xlanhuapec_&_OtherFactionWoodElves_&_Negative	wh2_main_sc_lzd_lizardmen
diplomacy_FactionGroup_LZD_Saurus2_Faction_Xlanhuapec_&_OtherFactionWoodElves_&_Positive	wh2_main_sc_lzd_lizardmen
diplomacy_FactionGroup_LZD_Saurus2_Faction_Xlanhuapec_&_Positive	wh2_main_sc_lzd_lizardmen
diplomacy_FactionGroup_LZD_SlannPriest1_Faction_SentinelsofXeti	wh2_main_sc_lzd_lizardmen
diplomacy_FactionGroup_LZD_SlannPriest1_Faction_SentinelsofXeti_&_Negative	wh2_main_sc_lzd_lizardmen
diplomacy_FactionGroup_LZD_SlannPriest1_Faction_SentinelsofXeti_&_OtherFactionBeastmen	wh2_main_sc_lzd_lizardmen
diplomacy_FactionGroup_LZD_SlannPriest1_Faction_SentinelsofXeti_&_OtherFactionBeastmen_&_Negative	wh2_main_sc_lzd_lizardmen
diplomacy_FactionGroup_LZD_SlannPriest1_Faction_SentinelsofXeti_&_OtherFactionBeastmen_&_Positive	wh2_main_sc_lzd_lizardmen
diplomacy_FactionGroup_LZD_SlannPriest1_Faction_SentinelsofXeti_&_OtherFactionBretonnia	wh2_main_sc_lzd_lizardmen
diplomacy_FactionGroup_LZD_SlannPriest1_Faction_SentinelsofXeti_&_OtherFactionBretonnia_&_Negative	wh2_main_sc_lzd_lizardmen
diplomacy_FactionGroup_LZD_SlannPriest1_Faction_SentinelsofXeti_&_OtherFactionBretonnia_&_Positive	wh2_main_sc_lzd_lizardmen
diplomacy_FactionGroup_LZD_SlannPriest1_Faction_SentinelsofXeti_&_OtherFactionChaos	wh2_main_sc_lzd_lizardmen
diplomacy_FactionGroup_LZD_SlannPriest1_Faction_SentinelsofXeti_&_OtherFactionChaos_&_Negative	wh2_main_sc_lzd_lizardmen
diplomacy_FactionGroup_LZD_SlannPriest1_Faction_SentinelsofXeti_&_OtherFactionChaos_&_Positive	wh2_main_sc_lzd_lizardmen
diplomacy_FactionGroup_LZD_SlannPriest1_Faction_SentinelsofXeti_&_OtherFactionDarkElves	wh2_main_sc_lzd_lizardmen
diplomacy_FactionGroup_LZD_SlannPriest1_Faction_SentinelsofXeti_&_OtherFactionDarkElves_&_Negative	wh2_main_sc_lzd_lizardmen
diplomacy_FactionGroup_LZD_SlannPriest1_Faction_SentinelsofXeti_&_OtherFactionDarkElves_&_Positive	wh2_main_sc_lzd_lizardmen
diplomacy_FactionGroup_LZD_SlannPriest1_Faction_SentinelsofXeti_&_OtherFactionDwarf	wh2_main_sc_lzd_lizardmen
diplomacy_FactionGroup_LZD_SlannPriest1_Faction_SentinelsofXeti_&_OtherFactionDwarf_&_Negative	wh2_main_sc_lzd_lizardmen
diplomacy_FactionGroup_LZD_SlannPriest1_Faction_SentinelsofXeti_&_OtherFactionDwarf_&_Positive	wh2_main_sc_lzd_lizardmen
diplomacy_FactionGroup_LZD_SlannPriest1_Faction_SentinelsofXeti_&_OtherFactionEmpire	wh2_main_sc_lzd_lizardmen
diplomacy_FactionGroup_LZD_SlannPriest1_Faction_SentinelsofXeti_&_OtherFactionEmpire_&_Negative	wh2_main_sc_lzd_lizardmen
diplomacy_FactionGroup_LZD_SlannPriest1_Faction_SentinelsofXeti_&_OtherFactionEmpire_&_Positive	wh2_main_sc_lzd_lizardmen
diplomacy_FactionGroup_LZD_SlannPriest1_Faction_SentinelsofXeti_&_OtherFactionGreenskin	wh2_main_sc_lzd_lizardmen
diplomacy_FactionGroup_LZD_SlannPriest1_Faction_SentinelsofXeti_&_OtherFactionGreenskin_&_Negative	wh2_main_sc_lzd_lizardmen
diplomacy_FactionGroup_LZD_SlannPriest1_Faction_SentinelsofXeti_&_OtherFactionGreenskin_&_Positive	wh2_main_sc_lzd_lizardmen
diplomacy_FactionGroup_LZD_SlannPriest1_Faction_SentinelsofXeti_&_OtherFactionHighElves	wh2_main_sc_lzd_lizardmen
diplomacy_FactionGroup_LZD_SlannPriest1_Faction_SentinelsofXeti_&_OtherFactionHighElves_&_Negative	wh2_main_sc_lzd_lizardmen
diplomacy_FactionGroup_LZD_SlannPriest1_Faction_SentinelsofXeti_&_OtherFactionHighElves_&_Positive	wh2_main_sc_lzd_lizardmen
diplomacy_FactionGroup_LZD_SlannPriest1_Faction_SentinelsofXeti_&_OtherFactionLizardmen	wh2_main_sc_lzd_lizardmen
diplomacy_FactionGroup_LZD_SlannPriest1_Faction_SentinelsofXeti_&_OtherFactionLizardmen_&_Negative	wh2_main_sc_lzd_lizardmen
diplomacy_FactionGroup_LZD_SlannPriest1_Faction_SentinelsofXeti_&_OtherFactionLizardmen_&_Positive	wh2_main_sc_lzd_lizardmen
diplomacy_FactionGroup_LZD_SlannPriest1_Faction_SentinelsofXeti_&_OtherFactionSkaven	wh2_main_sc_lzd_lizardmen
diplomacy_FactionGroup_LZD_SlannPriest1_Faction_SentinelsofXeti_&_OtherFactionSkaven_&_Negative	wh2_main_sc_lzd_lizardmen
diplomacy_FactionGroup_LZD_SlannPriest1_Faction_SentinelsofXeti_&_OtherFactionSkaven_&_Positive	wh2_main_sc_lzd_lizardmen
diplomacy_FactionGroup_LZD_SlannPriest1_Faction_SentinelsofXeti_&_OtherFactionVamp	wh2_main_sc_lzd_lizardmen
diplomacy_FactionGroup_LZD_SlannPriest1_Faction_SentinelsofXeti_&_OtherFactionVamp_&_Negative	wh2_main_sc_lzd_lizardmen
diplomacy_FactionGroup_LZD_SlannPriest1_Faction_SentinelsofXeti_&_OtherFactionVamp_&_Positive	wh2_main_sc_lzd_lizardmen
diplomacy_FactionGroup_LZD_SlannPriest1_Faction_SentinelsofXeti_&_OtherFactionWoodElves	wh2_main_sc_lzd_lizardmen
diplomacy_FactionGroup_LZD_SlannPriest1_Faction_SentinelsofXeti_&_OtherFactionWoodElves_&_Negative	wh2_main_sc_lzd_lizardmen
diplomacy_FactionGroup_LZD_SlannPriest1_Faction_SentinelsofXeti_&_OtherFactionWoodElves_&_Positive	wh2_main_sc_lzd_lizardmen
diplomacy_FactionGroup_LZD_SlannPriest1_Faction_SentinelsofXeti_&_Positive	wh2_main_sc_lzd_lizardmen
diplomacy_FactionGroup_LZD_SlannPriest1_Faction_Teotiqua	wh2_main_sc_lzd_lizardmen
diplomacy_FactionGroup_LZD_SlannPriest1_Faction_Teotiqua_&_Negative	wh2_main_sc_lzd_lizardmen
diplomacy_FactionGroup_LZD_SlannPriest1_Faction_Teotiqua_&_OtherFactionBeastmen	wh2_main_sc_lzd_lizardmen
diplomacy_FactionGroup_LZD_SlannPriest1_Faction_Teotiqua_&_OtherFactionBeastmen_&_Negative	wh2_main_sc_lzd_lizardmen
diplomacy_FactionGroup_LZD_SlannPriest1_Faction_Teotiqua_&_OtherFactionBeastmen_&_Positive	wh2_main_sc_lzd_lizardmen
diplomacy_FactionGroup_LZD_SlannPriest1_Faction_Teotiqua_&_OtherFactionBretonnia	wh2_main_sc_lzd_lizardmen
diplomacy_FactionGroup_LZD_SlannPriest1_Faction_Teotiqua_&_OtherFactionBretonnia_&_Negative	wh2_main_sc_lzd_lizardmen
diplomacy_FactionGroup_LZD_SlannPriest1_Faction_Teotiqua_&_OtherFactionBretonnia_&_Positive	wh2_main_sc_lzd_lizardmen
diplomacy_FactionGroup_LZD_SlannPriest1_Faction_Teotiqua_&_OtherFactionChaos	wh2_main_sc_lzd_lizardmen
diplomacy_FactionGroup_LZD_SlannPriest1_Faction_Teotiqua_&_OtherFactionChaos_&_Negative	wh2_main_sc_lzd_lizardmen
diplomacy_FactionGroup_LZD_SlannPriest1_Faction_Teotiqua_&_OtherFactionChaos_&_Positive	wh2_main_sc_lzd_lizardmen
diplomacy_FactionGroup_LZD_SlannPriest1_Faction_Teotiqua_&_OtherFactionDarkElves	wh2_main_sc_lzd_lizardmen
diplomacy_FactionGroup_LZD_SlannPriest1_Faction_Teotiqua_&_OtherFactionDarkElves_&_Negative	wh2_main_sc_lzd_lizardmen
diplomacy_FactionGroup_LZD_SlannPriest1_Faction_Teotiqua_&_OtherFactionDarkElves_&_Positive	wh2_main_sc_lzd_lizardmen
diplomacy_FactionGroup_LZD_SlannPriest1_Faction_Teotiqua_&_OtherFactionDwarf	wh2_main_sc_lzd_lizardmen
diplomacy_FactionGroup_LZD_SlannPriest1_Faction_Teotiqua_&_OtherFactionDwarf_&_Negative	wh2_main_sc_lzd_lizardmen
diplomacy_FactionGroup_LZD_SlannPriest1_Faction_Teotiqua_&_OtherFactionDwarf_&_Positive	wh2_main_sc_lzd_lizardmen
diplomacy_FactionGroup_LZD_SlannPriest1_Faction_Teotiqua_&_OtherFactionEmpire	wh2_main_sc_lzd_lizardmen
diplomacy_FactionGroup_LZD_SlannPriest1_Faction_Teotiqua_&_OtherFactionEmpire_&_Negative	wh2_main_sc_lzd_lizardmen
diplomacy_FactionGroup_LZD_SlannPriest1_Faction_Teotiqua_&_OtherFactionEmpire_&_Positive	wh2_main_sc_lzd_lizardmen
diplomacy_FactionGroup_LZD_SlannPriest1_Faction_Teotiqua_&_OtherFactionGreenskin	wh2_main_sc_lzd_lizardmen
diplomacy_FactionGroup_LZD_SlannPriest1_Faction_Teotiqua_&_OtherFactionGreenskin_&_Negative	wh2_main_sc_lzd_lizardmen
diplomacy_FactionGroup_LZD_SlannPriest1_Faction_Teotiqua_&_OtherFactionGreenskin_&_Positive	wh2_main_sc_lzd_lizardmen
diplomacy_FactionGroup_LZD_SlannPriest1_Faction_Teotiqua_&_OtherFactionHighElves	wh2_main_sc_lzd_lizardmen
diplomacy_FactionGroup_LZD_SlannPriest1_Faction_Teotiqua_&_OtherFactionHighElves_&_Negative	wh2_main_sc_lzd_lizardmen
diplomacy_FactionGroup_LZD_SlannPriest1_Faction_Teotiqua_&_OtherFactionHighElves_&_Positive	wh2_main_sc_lzd_lizardmen
diplomacy_FactionGroup_LZD_SlannPriest1_Faction_Teotiqua_&_OtherFactionLizardmen	wh2_main_sc_lzd_lizardmen
diplomacy_FactionGroup_LZD_SlannPriest1_Faction_Teotiqua_&_OtherFactionLizardmen_&_Negative	wh2_main_sc_lzd_lizardmen
diplomacy_FactionGroup_LZD_SlannPriest1_Faction_Teotiqua_&_OtherFactionLizardmen_&_Positive	wh2_main_sc_lzd_lizardmen
diplomacy_FactionGroup_LZD_SlannPriest1_Faction_Teotiqua_&_OtherFactionSkaven	wh2_main_sc_lzd_lizardmen
diplomacy_FactionGroup_LZD_SlannPriest1_Faction_Teotiqua_&_OtherFactionSkaven_&_Negative	wh2_main_sc_lzd_lizardmen
diplomacy_FactionGroup_LZD_SlannPriest1_Faction_Teotiqua_&_OtherFactionSkaven_&_Positive	wh2_main_sc_lzd_lizardmen
diplomacy_FactionGroup_LZD_SlannPriest1_Faction_Teotiqua_&_OtherFactionVamp	wh2_main_sc_lzd_lizardmen
diplomacy_FactionGroup_LZD_SlannPriest1_Faction_Teotiqua_&_OtherFactionVamp_&_Negative	wh2_main_sc_lzd_lizardmen
diplomacy_FactionGroup_LZD_SlannPriest1_Faction_Teotiqua_&_OtherFactionVamp_&_Positive	wh2_main_sc_lzd_lizardmen
diplomacy_FactionGroup_LZD_SlannPriest1_Faction_Teotiqua_&_OtherFactionWoodElves	wh2_main_sc_lzd_lizardmen
diplomacy_FactionGroup_LZD_SlannPriest1_Faction_Teotiqua_&_OtherFactionWoodElves_&_Negative	wh2_main_sc_lzd_lizardmen
diplomacy_FactionGroup_LZD_SlannPriest1_Faction_Teotiqua_&_OtherFactionWoodElves_&_Positive	wh2_main_sc_lzd_lizardmen
diplomacy_FactionGroup_LZD_SlannPriest1_Faction_Teotiqua_&_Positive	wh2_main_sc_lzd_lizardmen
diplomacy_FactionGroup_LZD_SlannPriest2_Faction_Tlaxtlan	wh2_main_sc_lzd_lizardmen
diplomacy_FactionGroup_LZD_SlannPriest2_Faction_Tlaxtlan_&_Negative	wh2_main_sc_lzd_lizardmen
diplomacy_FactionGroup_LZD_SlannPriest2_Faction_Tlaxtlan_&_OtherFactionBeastmen	wh2_main_sc_lzd_lizardmen
diplomacy_FactionGroup_LZD_SlannPriest2_Faction_Tlaxtlan_&_OtherFactionBeastmen_&_Negative	wh2_main_sc_lzd_lizardmen
diplomacy_FactionGroup_LZD_SlannPriest2_Faction_Tlaxtlan_&_OtherFactionBeastmen_&_Positive	wh2_main_sc_lzd_lizardmen
diplomacy_FactionGroup_LZD_SlannPriest2_Faction_Tlaxtlan_&_OtherFactionBretonnia	wh2_main_sc_lzd_lizardmen
diplomacy_FactionGroup_LZD_SlannPriest2_Faction_Tlaxtlan_&_OtherFactionBretonnia_&_Negative	wh2_main_sc_lzd_lizardmen
diplomacy_FactionGroup_LZD_SlannPriest2_Faction_Tlaxtlan_&_OtherFactionBretonnia_&_Positive	wh2_main_sc_lzd_lizardmen
diplomacy_FactionGroup_LZD_SlannPriest2_Faction_Tlaxtlan_&_OtherFactionChaos	wh2_main_sc_lzd_lizardmen
diplomacy_FactionGroup_LZD_SlannPriest2_Faction_Tlaxtlan_&_OtherFactionChaos_&_Negative	wh2_main_sc_lzd_lizardmen
diplomacy_FactionGroup_LZD_SlannPriest2_Faction_Tlaxtlan_&_OtherFactionChaos_&_Positive	wh2_main_sc_lzd_lizardmen
diplomacy_FactionGroup_LZD_SlannPriest2_Faction_Tlaxtlan_&_OtherFactionDarkElves	wh2_main_sc_lzd_lizardmen
diplomacy_FactionGroup_LZD_SlannPriest2_Faction_Tlaxtlan_&_OtherFactionDarkElves_&_Negative	wh2_main_sc_lzd_lizardmen
diplomacy_FactionGroup_LZD_SlannPriest2_Faction_Tlaxtlan_&_OtherFactionDarkElves_&_Positive	wh2_main_sc_lzd_lizardmen
diplomacy_FactionGroup_LZD_SlannPriest2_Faction_Tlaxtlan_&_OtherFactionDwarf	wh2_main_sc_lzd_lizardmen
diplomacy_FactionGroup_LZD_SlannPriest2_Faction_Tlaxtlan_&_OtherFactionDwarf_&_Negative	wh2_main_sc_lzd_lizardmen
diplomacy_FactionGroup_LZD_SlannPriest2_Faction_Tlaxtlan_&_OtherFactionDwarf_&_Positive	wh2_main_sc_lzd_lizardmen
diplomacy_FactionGroup_LZD_SlannPriest2_Faction_Tlaxtlan_&_OtherFactionEmpire	wh2_main_sc_lzd_lizardmen
diplomacy_FactionGroup_LZD_SlannPriest2_Faction_Tlaxtlan_&_OtherFactionEmpire_&_Negative	wh2_main_sc_lzd_lizardmen
diplomacy_FactionGroup_LZD_SlannPriest2_Faction_Tlaxtlan_&_OtherFactionEmpire_&_Positive	wh2_main_sc_lzd_lizardmen
diplomacy_FactionGroup_LZD_SlannPriest2_Faction_Tlaxtlan_&_OtherFactionGreenskin	wh2_main_sc_lzd_lizardmen
diplomacy_FactionGroup_LZD_SlannPriest2_Faction_Tlaxtlan_&_OtherFactionGreenskin_&_Negative	wh2_main_sc_lzd_lizardmen
diplomacy_FactionGroup_LZD_SlannPriest2_Faction_Tlaxtlan_&_OtherFactionGreenskin_&_Positive	wh2_main_sc_lzd_lizardmen
diplomacy_FactionGroup_LZD_SlannPriest2_Faction_Tlaxtlan_&_OtherFactionHighElves	wh2_main_sc_lzd_lizardmen
diplomacy_FactionGroup_LZD_SlannPriest2_Faction_Tlaxtlan_&_OtherFactionHighElves_&_Negative	wh2_main_sc_lzd_lizardmen
diplomacy_FactionGroup_LZD_SlannPriest2_Faction_Tlaxtlan_&_OtherFactionHighElves_&_Positive	wh2_main_sc_lzd_lizardmen
diplomacy_FactionGroup_LZD_SlannPriest2_Faction_Tlaxtlan_&_OtherFactionLizardmen	wh2_main_sc_lzd_lizardmen
diplomacy_FactionGroup_LZD_SlannPriest2_Faction_Tlaxtlan_&_OtherFactionLizardmen_&_Negative	wh2_main_sc_lzd_lizardmen
diplomacy_FactionGroup_LZD_SlannPriest2_Faction_Tlaxtlan_&_OtherFactionLizardmen_&_Positive	wh2_main_sc_lzd_lizardmen
diplomacy_FactionGroup_LZD_SlannPriest2_Faction_Tlaxtlan_&_OtherFactionSkaven	wh2_main_sc_lzd_lizardmen
diplomacy_FactionGroup_LZD_SlannPriest2_Faction_Tlaxtlan_&_OtherFactionSkaven_&_Negative	wh2_main_sc_lzd_lizardmen
diplomacy_FactionGroup_LZD_SlannPriest2_Faction_Tlaxtlan_&_OtherFactionSkaven_&_Positive	wh2_main_sc_lzd_lizardmen
diplomacy_FactionGroup_LZD_SlannPriest2_Faction_Tlaxtlan_&_OtherFactionVamp	wh2_main_sc_lzd_lizardmen
diplomacy_FactionGroup_LZD_SlannPriest2_Faction_Tlaxtlan_&_OtherFactionVamp_&_Negative	wh2_main_sc_lzd_lizardmen
diplomacy_FactionGroup_LZD_SlannPriest2_Faction_Tlaxtlan_&_OtherFactionVamp_&_Positive	wh2_main_sc_lzd_lizardmen
diplomacy_FactionGroup_LZD_SlannPriest2_Faction_Tlaxtlan_&_OtherFactionWoodElves	wh2_main_sc_lzd_lizardmen
diplomacy_FactionGroup_LZD_SlannPriest2_Faction_Tlaxtlan_&_OtherFactionWoodElves_&_Negative	wh2_main_sc_lzd_lizardmen
diplomacy_FactionGroup_LZD_SlannPriest2_Faction_Tlaxtlan_&_OtherFactionWoodElves_&_Positive	wh2_main_sc_lzd_lizardmen
diplomacy_FactionGroup_LZD_SlannPriest2_Faction_Tlaxtlan_&_Positive	wh2_main_sc_lzd_lizardmen
diplomacy_FactionGroup_LZD_SlannPriest2_Faction_Zlatan	wh2_main_sc_lzd_lizardmen
diplomacy_FactionGroup_LZD_SlannPriest2_Faction_Zlatan_&_Negative	wh2_main_sc_lzd_lizardmen
diplomacy_FactionGroup_LZD_SlannPriest2_Faction_Zlatan_&_OtherFactionBeastmen	wh2_main_sc_lzd_lizardmen
diplomacy_FactionGroup_LZD_SlannPriest2_Faction_Zlatan_&_OtherFactionBeastmen_&_Negative	wh2_main_sc_lzd_lizardmen
diplomacy_FactionGroup_LZD_SlannPriest2_Faction_Zlatan_&_OtherFactionBeastmen_&_Positive	wh2_main_sc_lzd_lizardmen
diplomacy_FactionGroup_LZD_SlannPriest2_Faction_Zlatan_&_OtherFactionBretonnia	wh2_main_sc_lzd_lizardmen
diplomacy_FactionGroup_LZD_SlannPriest2_Faction_Zlatan_&_OtherFactionBretonnia_&_Negative	wh2_main_sc_lzd_lizardmen
diplomacy_FactionGroup_LZD_SlannPriest2_Faction_Zlatan_&_OtherFactionBretonnia_&_Positive	wh2_main_sc_lzd_lizardmen
diplomacy_FactionGroup_LZD_SlannPriest2_Faction_Zlatan_&_OtherFactionChaos	wh2_main_sc_lzd_lizardmen
diplomacy_FactionGroup_LZD_SlannPriest2_Faction_Zlatan_&_OtherFactionChaos_&_Negative	wh2_main_sc_lzd_lizardmen
diplomacy_FactionGroup_LZD_SlannPriest2_Faction_Zlatan_&_OtherFactionChaos_&_Positive	wh2_main_sc_lzd_lizardmen
diplomacy_FactionGroup_LZD_SlannPriest2_Faction_Zlatan_&_OtherFactionDarkElves	wh2_main_sc_lzd_lizardmen
diplomacy_FactionGroup_LZD_SlannPriest2_Faction_Zlatan_&_OtherFactionDarkElves_&_Negative	wh2_main_sc_lzd_lizardmen
diplomacy_FactionGroup_LZD_SlannPriest2_Faction_Zlatan_&_OtherFactionDarkElves_&_Positive	wh2_main_sc_lzd_lizardmen
diplomacy_FactionGroup_LZD_SlannPriest2_Faction_Zlatan_&_OtherFactionDwarf	wh2_main_sc_lzd_lizardmen
diplomacy_FactionGroup_LZD_SlannPriest2_Faction_Zlatan_&_OtherFactionDwarf_&_Negative	wh2_main_sc_lzd_lizardmen
diplomacy_FactionGroup_LZD_SlannPriest2_Faction_Zlatan_&_OtherFactionDwarf_&_Positive	wh2_main_sc_lzd_lizardmen
diplomacy_FactionGroup_LZD_SlannPriest2_Faction_Zlatan_&_OtherFactionEmpire	wh2_main_sc_lzd_lizardmen
diplomacy_FactionGroup_LZD_SlannPriest2_Faction_Zlatan_&_OtherFactionEmpire_&_Negative	wh2_main_sc_lzd_lizardmen
diplomacy_FactionGroup_LZD_SlannPriest2_Faction_Zlatan_&_OtherFactionEmpire_&_Positive	wh2_main_sc_lzd_lizardmen
diplomacy_FactionGroup_LZD_SlannPriest2_Faction_Zlatan_&_OtherFactionGreenskin	wh2_main_sc_lzd_lizardmen
diplomacy_FactionGroup_LZD_SlannPriest2_Faction_Zlatan_&_OtherFactionGreenskin_&_Negative	wh2_main_sc_lzd_lizardmen
diplomacy_FactionGroup_LZD_SlannPriest2_Faction_Zlatan_&_OtherFactionGreenskin_&_Positive	wh2_main_sc_lzd_lizardmen
diplomacy_FactionGroup_LZD_SlannPriest2_Faction_Zlatan_&_OtherFactionHighElves	wh2_main_sc_lzd_lizardmen
diplomacy_FactionGroup_LZD_SlannPriest2_Faction_Zlatan_&_OtherFactionHighElves_&_Negative	wh2_main_sc_lzd_lizardmen
diplomacy_FactionGroup_LZD_SlannPriest2_Faction_Zlatan_&_OtherFactionHighElves_&_Positive	wh2_main_sc_lzd_lizardmen
diplomacy_FactionGroup_LZD_SlannPriest2_Faction_Zlatan_&_OtherFactionLizardmen	wh2_main_sc_lzd_lizardmen
diplomacy_FactionGroup_LZD_SlannPriest2_Faction_Zlatan_&_OtherFactionLizardmen_&_Negative	wh2_main_sc_lzd_lizardmen
diplomacy_FactionGroup_LZD_SlannPriest2_Faction_Zlatan_&_OtherFactionLizardmen_&_Positive	wh2_main_sc_lzd_lizardmen
diplomacy_FactionGroup_LZD_SlannPriest2_Faction_Zlatan_&_OtherFactionSkaven	wh2_main_sc_lzd_lizardmen
diplomacy_FactionGroup_LZD_SlannPriest2_Faction_Zlatan_&_OtherFactionSkaven_&_Negative	wh2_main_sc_lzd_lizardmen
diplomacy_FactionGroup_LZD_SlannPriest2_Faction_Zlatan_&_OtherFactionSkaven_&_Positive	wh2_main_sc_lzd_lizardmen
diplomacy_FactionGroup_LZD_SlannPriest2_Faction_Zlatan_&_OtherFactionVamp	wh2_main_sc_lzd_lizardmen
diplomacy_FactionGroup_LZD_SlannPriest2_Faction_Zlatan_&_OtherFactionVamp_&_Negative	wh2_main_sc_lzd_lizardmen
diplomacy_FactionGroup_LZD_SlannPriest2_Faction_Zlatan_&_OtherFactionVamp_&_Positive	wh2_main_sc_lzd_lizardmen
diplomacy_FactionGroup_LZD_SlannPriest2_Faction_Zlatan_&_OtherFactionWoodElves	wh2_main_sc_lzd_lizardmen
diplomacy_FactionGroup_LZD_SlannPriest2_Faction_Zlatan_&_OtherFactionWoodElves_&_Negative	wh2_main_sc_lzd_lizardmen
diplomacy_FactionGroup_LZD_SlannPriest2_Faction_Zlatan_&_OtherFactionWoodElves_&_Positive	wh2_main_sc_lzd_lizardmen
diplomacy_FactionGroup_LZD_SlannPriest2_Faction_Zlatan_&_Positive	wh2_main_sc_lzd_lizardmen
diplomacy_FactionGroup_SKV_GreySeer_Faction_ClanMoulder	wh2_main_sc_skv_skaven
diplomacy_FactionGroup_SKV_GreySeer_Faction_ClanMoulder_&_Negative	wh2_main_sc_skv_skaven
diplomacy_FactionGroup_SKV_GreySeer_Faction_ClanMoulder_&_OtherFactionBeastmen	wh2_main_sc_skv_skaven
diplomacy_FactionGroup_SKV_GreySeer_Faction_ClanMoulder_&_OtherFactionBeastmen_&_Negative	wh2_main_sc_skv_skaven
diplomacy_FactionGroup_SKV_GreySeer_Faction_ClanMoulder_&_OtherFactionBeastmen_&_Positive	wh2_main_sc_skv_skaven
diplomacy_FactionGroup_SKV_GreySeer_Faction_ClanMoulder_&_OtherFactionBretonnia	wh2_main_sc_skv_skaven
diplomacy_FactionGroup_SKV_GreySeer_Faction_ClanMoulder_&_OtherFactionBretonnia_&_Negative	wh2_main_sc_skv_skaven
diplomacy_FactionGroup_SKV_GreySeer_Faction_ClanMoulder_&_OtherFactionBretonnia_&_Positive	wh2_main_sc_skv_skaven
diplomacy_FactionGroup_SKV_GreySeer_Faction_ClanMoulder_&_OtherFactionChaos	wh2_main_sc_skv_skaven
diplomacy_FactionGroup_SKV_GreySeer_Faction_ClanMoulder_&_OtherFactionChaos_&_Negative	wh2_main_sc_skv_skaven
diplomacy_FactionGroup_SKV_GreySeer_Faction_ClanMoulder_&_OtherFactionChaos_&_Positive	wh2_main_sc_skv_skaven
diplomacy_FactionGroup_SKV_GreySeer_Faction_ClanMoulder_&_OtherFactionDarkElves	wh2_main_sc_skv_skaven
diplomacy_FactionGroup_SKV_GreySeer_Faction_ClanMoulder_&_OtherFactionDarkElves_&_Negative	wh2_main_sc_skv_skaven
diplomacy_FactionGroup_SKV_GreySeer_Faction_ClanMoulder_&_OtherFactionDarkElves_&_Positive	wh2_main_sc_skv_skaven
diplomacy_FactionGroup_SKV_GreySeer_Faction_ClanMoulder_&_OtherFactionDwarf	wh2_main_sc_skv_skaven
diplomacy_FactionGroup_SKV_GreySeer_Faction_ClanMoulder_&_OtherFactionDwarf_&_Negative	wh2_main_sc_skv_skaven
diplomacy_FactionGroup_SKV_GreySeer_Faction_ClanMoulder_&_OtherFactionDwarf_&_Positive	wh2_main_sc_skv_skaven
diplomacy_FactionGroup_SKV_GreySeer_Faction_ClanMoulder_&_OtherFactionEmpire	wh2_main_sc_skv_skaven
diplomacy_FactionGroup_SKV_GreySeer_Faction_ClanMoulder_&_OtherFactionEmpire_&_Negative	wh2_main_sc_skv_skaven
diplomacy_FactionGroup_SKV_GreySeer_Faction_ClanMoulder_&_OtherFactionEmpire_&_Positive	wh2_main_sc_skv_skaven
diplomacy_FactionGroup_SKV_GreySeer_Faction_ClanMoulder_&_OtherFactionGreenskin	wh2_main_sc_skv_skaven
diplomacy_FactionGroup_SKV_GreySeer_Faction_ClanMoulder_&_OtherFactionGreenskin_&_Negative	wh2_main_sc_skv_skaven
diplomacy_FactionGroup_SKV_GreySeer_Faction_ClanMoulder_&_OtherFactionGreenskin_&_Positive	wh2_main_sc_skv_skaven
diplomacy_FactionGroup_SKV_GreySeer_Faction_ClanMoulder_&_OtherFactionHighElves	wh2_main_sc_skv_skaven
diplomacy_FactionGroup_SKV_GreySeer_Faction_ClanMoulder_&_OtherFactionHighElves_&_Negative	wh2_main_sc_skv_skaven
diplomacy_FactionGroup_SKV_GreySeer_Faction_ClanMoulder_&_OtherFactionHighElves_&_Positive	wh2_main_sc_skv_skaven
diplomacy_FactionGroup_SKV_GreySeer_Faction_ClanMoulder_&_OtherFactionLizardmen	wh2_main_sc_skv_skaven
diplomacy_FactionGroup_SKV_GreySeer_Faction_ClanMoulder_&_OtherFactionLizardmen_&_Negative	wh2_main_sc_skv_skaven
diplomacy_FactionGroup_SKV_GreySeer_Faction_ClanMoulder_&_OtherFactionLizardmen_&_Positive	wh2_main_sc_skv_skaven
diplomacy_FactionGroup_SKV_GreySeer_Faction_ClanMoulder_&_OtherFactionSkaven	wh2_main_sc_skv_skaven
diplomacy_FactionGroup_SKV_GreySeer_Faction_ClanMoulder_&_OtherFactionSkaven_&_Negative	wh2_main_sc_skv_skaven
diplomacy_FactionGroup_SKV_GreySeer_Faction_ClanMoulder_&_OtherFactionSkaven_&_Positive	wh2_main_sc_skv_skaven
diplomacy_FactionGroup_SKV_GreySeer_Faction_ClanMoulder_&_OtherFactionVamp	wh2_main_sc_skv_skaven
diplomacy_FactionGroup_SKV_GreySeer_Faction_ClanMoulder_&_OtherFactionVamp_&_Negative	wh2_main_sc_skv_skaven
diplomacy_FactionGroup_SKV_GreySeer_Faction_ClanMoulder_&_OtherFactionVamp_&_Positive	wh2_main_sc_skv_skaven
diplomacy_FactionGroup_SKV_GreySeer_Faction_ClanMoulder_&_OtherFactionWoodElves	wh2_main_sc_skv_skaven
diplomacy_FactionGroup_SKV_GreySeer_Faction_ClanMoulder_&_OtherFactionWoodElves_&_Negative	wh2_main_sc_skv_skaven
diplomacy_FactionGroup_SKV_GreySeer_Faction_ClanMoulder_&_OtherFactionWoodElves_&_Positive	wh2_main_sc_skv_skaven
diplomacy_FactionGroup_SKV_GreySeer_Faction_ClanMoulder_&_Positive	wh2_main_sc_skv_skaven
diplomacy_FactionGroup_SKV_GreySeer_Faction_ClanSkyre	wh2_main_sc_skv_skaven
diplomacy_FactionGroup_SKV_GreySeer_Faction_ClanSkyre_&_Negative	wh2_main_sc_skv_skaven
diplomacy_FactionGroup_SKV_GreySeer_Faction_ClanSkyre_&_OtherFactionBeastmen	wh2_main_sc_skv_skaven
diplomacy_FactionGroup_SKV_GreySeer_Faction_ClanSkyre_&_OtherFactionBeastmen_&_Negative	wh2_main_sc_skv_skaven
diplomacy_FactionGroup_SKV_GreySeer_Faction_ClanSkyre_&_OtherFactionBeastmen_&_Positive	wh2_main_sc_skv_skaven
diplomacy_FactionGroup_SKV_GreySeer_Faction_ClanSkyre_&_OtherFactionBretonnia	wh2_main_sc_skv_skaven
diplomacy_FactionGroup_SKV_GreySeer_Faction_ClanSkyre_&_OtherFactionBretonnia_&_Negative	wh2_main_sc_skv_skaven
diplomacy_FactionGroup_SKV_GreySeer_Faction_ClanSkyre_&_OtherFactionBretonnia_&_Positive	wh2_main_sc_skv_skaven
diplomacy_FactionGroup_SKV_GreySeer_Faction_ClanSkyre_&_OtherFactionChaos	wh2_main_sc_skv_skaven
diplomacy_FactionGroup_SKV_GreySeer_Faction_ClanSkyre_&_OtherFactionChaos_&_Negative	wh2_main_sc_skv_skaven
diplomacy_FactionGroup_SKV_GreySeer_Faction_ClanSkyre_&_OtherFactionChaos_&_Positive	wh2_main_sc_skv_skaven
diplomacy_FactionGroup_SKV_GreySeer_Faction_ClanSkyre_&_OtherFactionDarkElves	wh2_main_sc_skv_skaven
diplomacy_FactionGroup_SKV_GreySeer_Faction_ClanSkyre_&_OtherFactionDarkElves_&_Negative	wh2_main_sc_skv_skaven
diplomacy_FactionGroup_SKV_GreySeer_Faction_ClanSkyre_&_OtherFactionDarkElves_&_Positive	wh2_main_sc_skv_skaven
diplomacy_FactionGroup_SKV_GreySeer_Faction_ClanSkyre_&_OtherFactionDwarf	wh2_main_sc_skv_skaven
diplomacy_FactionGroup_SKV_GreySeer_Faction_ClanSkyre_&_OtherFactionDwarf_&_Negative	wh2_main_sc_skv_skaven
diplomacy_FactionGroup_SKV_GreySeer_Faction_ClanSkyre_&_OtherFactionDwarf_&_Positive	wh2_main_sc_skv_skaven
diplomacy_FactionGroup_SKV_GreySeer_Faction_ClanSkyre_&_OtherFactionEmpire	wh2_main_sc_skv_skaven
diplomacy_FactionGroup_SKV_GreySeer_Faction_ClanSkyre_&_OtherFactionEmpire_&_Negative	wh2_main_sc_skv_skaven
diplomacy_FactionGroup_SKV_GreySeer_Faction_ClanSkyre_&_OtherFactionEmpire_&_Positive	wh2_main_sc_skv_skaven
diplomacy_FactionGroup_SKV_GreySeer_Faction_ClanSkyre_&_OtherFactionGreenskin	wh2_main_sc_skv_skaven
diplomacy_FactionGroup_SKV_GreySeer_Faction_ClanSkyre_&_OtherFactionGreenskin_&_Negative	wh2_main_sc_skv_skaven
diplomacy_FactionGroup_SKV_GreySeer_Faction_ClanSkyre_&_OtherFactionGreenskin_&_Positive	wh2_main_sc_skv_skaven
diplomacy_FactionGroup_SKV_GreySeer_Faction_ClanSkyre_&_OtherFactionHighElves	wh2_main_sc_skv_skaven
diplomacy_FactionGroup_SKV_GreySeer_Faction_ClanSkyre_&_OtherFactionHighElves_&_Negative	wh2_main_sc_skv_skaven
diplomacy_FactionGroup_SKV_GreySeer_Faction_ClanSkyre_&_OtherFactionHighElves_&_Positive	wh2_main_sc_skv_skaven
diplomacy_FactionGroup_SKV_GreySeer_Faction_ClanSkyre_&_OtherFactionLizardmen	wh2_main_sc_skv_skaven
diplomacy_FactionGroup_SKV_GreySeer_Faction_ClanSkyre_&_OtherFactionLizardmen_&_Negative	wh2_main_sc_skv_skaven
diplomacy_FactionGroup_SKV_GreySeer_Faction_ClanSkyre_&_OtherFactionLizardmen_&_Positive	wh2_main_sc_skv_skaven
diplomacy_FactionGroup_SKV_GreySeer_Faction_ClanSkyre_&_OtherFactionSkaven	wh2_main_sc_skv_skaven
diplomacy_FactionGroup_SKV_GreySeer_Faction_ClanSkyre_&_OtherFactionSkaven_&_Negative	wh2_main_sc_skv_skaven
diplomacy_FactionGroup_SKV_GreySeer_Faction_ClanSkyre_&_OtherFactionSkaven_&_Positive	wh2_main_sc_skv_skaven
diplomacy_FactionGroup_SKV_GreySeer_Faction_ClanSkyre_&_OtherFactionVamp	wh2_main_sc_skv_skaven
diplomacy_FactionGroup_SKV_GreySeer_Faction_ClanSkyre_&_OtherFactionVamp_&_Negative	wh2_main_sc_skv_skaven
diplomacy_FactionGroup_SKV_GreySeer_Faction_ClanSkyre_&_OtherFactionVamp_&_Positive	wh2_main_sc_skv_skaven
diplomacy_FactionGroup_SKV_GreySeer_Faction_ClanSkyre_&_OtherFactionWoodElves	wh2_main_sc_skv_skaven
diplomacy_FactionGroup_SKV_GreySeer_Faction_ClanSkyre_&_OtherFactionWoodElves_&_Negative	wh2_main_sc_skv_skaven
diplomacy_FactionGroup_SKV_GreySeer_Faction_ClanSkyre_&_OtherFactionWoodElves_&_Positive	wh2_main_sc_skv_skaven
diplomacy_FactionGroup_SKV_GreySeer_Faction_ClanSkyre_&_Positive	wh2_main_sc_skv_skaven
diplomacy_FactionGroup_SKV_Warlord_Faction_ClanEshin	wh2_main_sc_skv_skaven
diplomacy_FactionGroup_SKV_Warlord_Faction_ClanEshin_&_Negative	wh2_main_sc_skv_skaven
diplomacy_FactionGroup_SKV_Warlord_Faction_ClanEshin_&_OtherFactionBeastmen	wh2_main_sc_skv_skaven
diplomacy_FactionGroup_SKV_Warlord_Faction_ClanEshin_&_OtherFactionBeastmen_&_Negative	wh2_main_sc_skv_skaven
diplomacy_FactionGroup_SKV_Warlord_Faction_ClanEshin_&_OtherFactionBeastmen_&_Positive	wh2_main_sc_skv_skaven
diplomacy_FactionGroup_SKV_Warlord_Faction_ClanEshin_&_OtherFactionBretonnia	wh2_main_sc_skv_skaven
diplomacy_FactionGroup_SKV_Warlord_Faction_ClanEshin_&_OtherFactionBretonnia_&_Negative	wh2_main_sc_skv_skaven
diplomacy_FactionGroup_SKV_Warlord_Faction_ClanEshin_&_OtherFactionBretonnia_&_Positive	wh2_main_sc_skv_skaven
diplomacy_FactionGroup_SKV_Warlord_Faction_ClanEshin_&_OtherFactionChaos	wh2_main_sc_skv_skaven
diplomacy_FactionGroup_SKV_Warlord_Faction_ClanEshin_&_OtherFactionChaos_&_Negative	wh2_main_sc_skv_skaven
diplomacy_FactionGroup_SKV_Warlord_Faction_ClanEshin_&_OtherFactionChaos_&_Positive	wh2_main_sc_skv_skaven
diplomacy_FactionGroup_SKV_Warlord_Faction_ClanEshin_&_OtherFactionDarkElves	wh2_main_sc_skv_skaven
diplomacy_FactionGroup_SKV_Warlord_Faction_ClanEshin_&_OtherFactionDarkElves_&_Negative	wh2_main_sc_skv_skaven
diplomacy_FactionGroup_SKV_Warlord_Faction_ClanEshin_&_OtherFactionDarkElves_&_Positive	wh2_main_sc_skv_skaven
diplomacy_FactionGroup_SKV_Warlord_Faction_ClanEshin_&_OtherFactionDwarf	wh2_main_sc_skv_skaven
diplomacy_FactionGroup_SKV_Warlord_Faction_ClanEshin_&_OtherFactionDwarf_&_Negative	wh2_main_sc_skv_skaven
diplomacy_FactionGroup_SKV_Warlord_Faction_ClanEshin_&_OtherFactionDwarf_&_Positive	wh2_main_sc_skv_skaven
diplomacy_FactionGroup_SKV_Warlord_Faction_ClanEshin_&_OtherFactionEmpire	wh2_main_sc_skv_skaven
diplomacy_FactionGroup_SKV_Warlord_Faction_ClanEshin_&_OtherFactionEmpire_&_Negative	wh2_main_sc_skv_skaven
diplomacy_FactionGroup_SKV_Warlord_Faction_ClanEshin_&_OtherFactionEmpire_&_Positive	wh2_main_sc_skv_skaven
diplomacy_FactionGroup_SKV_Warlord_Faction_ClanEshin_&_OtherFactionGreenskin	wh2_main_sc_skv_skaven
diplomacy_FactionGroup_SKV_Warlord_Faction_ClanEshin_&_OtherFactionGreenskin_&_Negative	wh2_main_sc_skv_skaven
diplomacy_FactionGroup_SKV_Warlord_Faction_ClanEshin_&_OtherFactionGreenskin_&_Positive	wh2_main_sc_skv_skaven
diplomacy_FactionGroup_SKV_Warlord_Faction_ClanEshin_&_OtherFactionHighElves	wh2_main_sc_skv_skaven
diplomacy_FactionGroup_SKV_Warlord_Faction_ClanEshin_&_OtherFactionHighElves_&_Negative	wh2_main_sc_skv_skaven
diplomacy_FactionGroup_SKV_Warlord_Faction_ClanEshin_&_OtherFactionHighElves_&_Positive	wh2_main_sc_skv_skaven
diplomacy_FactionGroup_SKV_Warlord_Faction_ClanEshin_&_OtherFactionLizardmen	wh2_main_sc_skv_skaven
diplomacy_FactionGroup_SKV_Warlord_Faction_ClanEshin_&_OtherFactionLizardmen_&_Negative	wh2_main_sc_skv_skaven
diplomacy_FactionGroup_SKV_Warlord_Faction_ClanEshin_&_OtherFactionLizardmen_&_Positive	wh2_main_sc_skv_skaven
diplomacy_FactionGroup_SKV_Warlord_Faction_ClanEshin_&_OtherFactionSkaven	wh2_main_sc_skv_skaven
diplomacy_FactionGroup_SKV_Warlord_Faction_ClanEshin_&_OtherFactionSkaven_&_Negative	wh2_main_sc_skv_skaven
diplomacy_FactionGroup_SKV_Warlord_Faction_ClanEshin_&_OtherFactionSkaven_&_Positive	wh2_main_sc_skv_skaven
diplomacy_FactionGroup_SKV_Warlord_Faction_ClanEshin_&_OtherFactionVamp	wh2_main_sc_skv_skaven
diplomacy_FactionGroup_SKV_Warlord_Faction_ClanEshin_&_OtherFactionVamp_&_Negative	wh2_main_sc_skv_skaven
diplomacy_FactionGroup_SKV_Warlord_Faction_ClanEshin_&_OtherFactionVamp_&_Positive	wh2_main_sc_skv_skaven
diplomacy_FactionGroup_SKV_Warlord_Faction_ClanEshin_&_OtherFactionWoodElves	wh2_main_sc_skv_skaven
diplomacy_FactionGroup_SKV_Warlord_Faction_ClanEshin_&_OtherFactionWoodElves_&_Negative	wh2_main_sc_skv_skaven
diplomacy_FactionGroup_SKV_Warlord_Faction_ClanEshin_&_OtherFactionWoodElves_&_Positive	wh2_main_sc_skv_skaven
diplomacy_FactionGroup_SKV_Warlord_Faction_ClanEshin_&_Positive	wh2_main_sc_skv_skaven
diplomacy_FactionGroup_SKV_Warlord_Faction_ClanGnaw	wh2_main_sc_skv_skaven
diplomacy_FactionGroup_SKV_Warlord_Faction_ClanGnaw_&_Negative	wh2_main_sc_skv_skaven
diplomacy_FactionGroup_SKV_Warlord_Faction_ClanGnaw_&_OtherFactionBeastmen	wh2_main_sc_skv_skaven
diplomacy_FactionGroup_SKV_Warlord_Faction_ClanGnaw_&_OtherFactionBeastmen_&_Negative	wh2_main_sc_skv_skaven
diplomacy_FactionGroup_SKV_Warlord_Faction_ClanGnaw_&_OtherFactionBeastmen_&_Positive	wh2_main_sc_skv_skaven
diplomacy_FactionGroup_SKV_Warlord_Faction_ClanGnaw_&_OtherFactionBretonnia	wh2_main_sc_skv_skaven
diplomacy_FactionGroup_SKV_Warlord_Faction_ClanGnaw_&_OtherFactionBretonnia_&_Negative	wh2_main_sc_skv_skaven
diplomacy_FactionGroup_SKV_Warlord_Faction_ClanGnaw_&_OtherFactionBretonnia_&_Positive	wh2_main_sc_skv_skaven
diplomacy_FactionGroup_SKV_Warlord_Faction_ClanGnaw_&_OtherFactionChaos	wh2_main_sc_skv_skaven
diplomacy_FactionGroup_SKV_Warlord_Faction_ClanGnaw_&_OtherFactionChaos_&_Negative	wh2_main_sc_skv_skaven
diplomacy_FactionGroup_SKV_Warlord_Faction_ClanGnaw_&_OtherFactionChaos_&_Positive	wh2_main_sc_skv_skaven
diplomacy_FactionGroup_SKV_Warlord_Faction_ClanGnaw_&_OtherFactionDarkElves	wh2_main_sc_skv_skaven
diplomacy_FactionGroup_SKV_Warlord_Faction_ClanGnaw_&_OtherFactionDarkElves_&_Negative	wh2_main_sc_skv_skaven
diplomacy_FactionGroup_SKV_Warlord_Faction_ClanGnaw_&_OtherFactionDarkElves_&_Positive	wh2_main_sc_skv_skaven
diplomacy_FactionGroup_SKV_Warlord_Faction_ClanGnaw_&_OtherFactionDwarf	wh2_main_sc_skv_skaven
diplomacy_FactionGroup_SKV_Warlord_Faction_ClanGnaw_&_OtherFactionDwarf_&_Negative	wh2_main_sc_skv_skaven
diplomacy_FactionGroup_SKV_Warlord_Faction_ClanGnaw_&_OtherFactionDwarf_&_Positive	wh2_main_sc_skv_skaven
diplomacy_FactionGroup_SKV_Warlord_Faction_ClanGnaw_&_OtherFactionEmpire	wh2_main_sc_skv_skaven
diplomacy_FactionGroup_SKV_Warlord_Faction_ClanGnaw_&_OtherFactionEmpire_&_Negative	wh2_main_sc_skv_skaven
diplomacy_FactionGroup_SKV_Warlord_Faction_ClanGnaw_&_OtherFactionEmpire_&_Positive	wh2_main_sc_skv_skaven
diplomacy_FactionGroup_SKV_Warlord_Faction_ClanGnaw_&_OtherFactionGreenskin	wh2_main_sc_skv_skaven
diplomacy_FactionGroup_SKV_Warlord_Faction_ClanGnaw_&_OtherFactionGreenskin_&_Negative	wh2_main_sc_skv_skaven
diplomacy_FactionGroup_SKV_Warlord_Faction_ClanGnaw_&_OtherFactionGreenskin_&_Positive	wh2_main_sc_skv_skaven
diplomacy_FactionGroup_SKV_Warlord_Faction_ClanGnaw_&_OtherFactionHighElves	wh2_main_sc_skv_skaven
diplomacy_FactionGroup_SKV_Warlord_Faction_ClanGnaw_&_OtherFactionHighElves_&_Negative	wh2_main_sc_skv_skaven
diplomacy_FactionGroup_SKV_Warlord_Faction_ClanGnaw_&_OtherFactionHighElves_&_Positive	wh2_main_sc_skv_skaven
diplomacy_FactionGroup_SKV_Warlord_Faction_ClanGnaw_&_OtherFactionLizardmen	wh2_main_sc_skv_skaven
diplomacy_FactionGroup_SKV_Warlord_Faction_ClanGnaw_&_OtherFactionLizardmen_&_Negative	wh2_main_sc_skv_skaven
diplomacy_FactionGroup_SKV_Warlord_Faction_ClanGnaw_&_OtherFactionLizardmen_&_Positive	wh2_main_sc_skv_skaven
diplomacy_FactionGroup_SKV_Warlord_Faction_ClanGnaw_&_OtherFactionSkaven	wh2_main_sc_skv_skaven
diplomacy_FactionGroup_SKV_Warlord_Faction_ClanGnaw_&_OtherFactionSkaven_&_Negative	wh2_main_sc_skv_skaven
diplomacy_FactionGroup_SKV_Warlord_Faction_ClanGnaw_&_OtherFactionSkaven_&_Positive	wh2_main_sc_skv_skaven
diplomacy_FactionGroup_SKV_Warlord_Faction_ClanGnaw_&_OtherFactionVamp	wh2_main_sc_skv_skaven
diplomacy_FactionGroup_SKV_Warlord_Faction_ClanGnaw_&_OtherFactionVamp_&_Negative	wh2_main_sc_skv_skaven
diplomacy_FactionGroup_SKV_Warlord_Faction_ClanGnaw_&_OtherFactionVamp_&_Positive	wh2_main_sc_skv_skaven
diplomacy_FactionGroup_SKV_Warlord_Faction_ClanGnaw_&_OtherFactionWoodElves	wh2_main_sc_skv_skaven
diplomacy_FactionGroup_SKV_Warlord_Faction_ClanGnaw_&_OtherFactionWoodElves_&_Negative	wh2_main_sc_skv_skaven
diplomacy_FactionGroup_SKV_Warlord_Faction_ClanGnaw_&_OtherFactionWoodElves_&_Positive	wh2_main_sc_skv_skaven
diplomacy_FactionGroup_SKV_Warlord_Faction_ClanGnaw_&_Positive	wh2_main_sc_skv_skaven
diplomacy_FactionGroup_SKV_Warlord_Faction_ClanMordkin	wh2_main_sc_skv_skaven
diplomacy_FactionGroup_SKV_Warlord_Faction_ClanMordkin_&_Negative	wh2_main_sc_skv_skaven
diplomacy_FactionGroup_SKV_Warlord_Faction_ClanMordkin_&_OtherFactionBeastmen	wh2_main_sc_skv_skaven
diplomacy_FactionGroup_SKV_Warlord_Faction_ClanMordkin_&_OtherFactionBeastmen_&_Negative	wh2_main_sc_skv_skaven
diplomacy_FactionGroup_SKV_Warlord_Faction_ClanMordkin_&_OtherFactionBeastmen_&_Positive	wh2_main_sc_skv_skaven
diplomacy_FactionGroup_SKV_Warlord_Faction_ClanMordkin_&_OtherFactionBretonnia	wh2_main_sc_skv_skaven
diplomacy_FactionGroup_SKV_Warlord_Faction_ClanMordkin_&_OtherFactionBretonnia_&_Negative	wh2_main_sc_skv_skaven
diplomacy_FactionGroup_SKV_Warlord_Faction_ClanMordkin_&_OtherFactionBretonnia_&_Positive	wh2_main_sc_skv_skaven
diplomacy_FactionGroup_SKV_Warlord_Faction_ClanMordkin_&_OtherFactionChaos	wh2_main_sc_skv_skaven
diplomacy_FactionGroup_SKV_Warlord_Faction_ClanMordkin_&_OtherFactionChaos_&_Negative	wh2_main_sc_skv_skaven
diplomacy_FactionGroup_SKV_Warlord_Faction_ClanMordkin_&_OtherFactionChaos_&_Positive	wh2_main_sc_skv_skaven
diplomacy_FactionGroup_SKV_Warlord_Faction_ClanMordkin_&_OtherFactionDarkElves	wh2_main_sc_skv_skaven
diplomacy_FactionGroup_SKV_Warlord_Faction_ClanMordkin_&_OtherFactionDarkElves_&_Negative	wh2_main_sc_skv_skaven
diplomacy_FactionGroup_SKV_Warlord_Faction_ClanMordkin_&_OtherFactionDarkElves_&_Positive	wh2_main_sc_skv_skaven
diplomacy_FactionGroup_SKV_Warlord_Faction_ClanMordkin_&_OtherFactionDwarf	wh2_main_sc_skv_skaven
diplomacy_FactionGroup_SKV_Warlord_Faction_ClanMordkin_&_OtherFactionDwarf_&_Negative	wh2_main_sc_skv_skaven
diplomacy_FactionGroup_SKV_Warlord_Faction_ClanMordkin_&_OtherFactionDwarf_&_Positive	wh2_main_sc_skv_skaven
diplomacy_FactionGroup_SKV_Warlord_Faction_ClanMordkin_&_OtherFactionEmpire	wh2_main_sc_skv_skaven
diplomacy_FactionGroup_SKV_Warlord_Faction_ClanMordkin_&_OtherFactionEmpire_&_Negative	wh2_main_sc_skv_skaven
diplomacy_FactionGroup_SKV_Warlord_Faction_ClanMordkin_&_OtherFactionEmpire_&_Positive	wh2_main_sc_skv_skaven
diplomacy_FactionGroup_SKV_Warlord_Faction_ClanMordkin_&_OtherFactionGreenskin	wh2_main_sc_skv_skaven
diplomacy_FactionGroup_SKV_Warlord_Faction_ClanMordkin_&_OtherFactionGreenskin_&_Negative	wh2_main_sc_skv_skaven
diplomacy_FactionGroup_SKV_Warlord_Faction_ClanMordkin_&_OtherFactionGreenskin_&_Positive	wh2_main_sc_skv_skaven
diplomacy_FactionGroup_SKV_Warlord_Faction_ClanMordkin_&_OtherFactionHighElves	wh2_main_sc_skv_skaven
diplomacy_FactionGroup_SKV_Warlord_Faction_ClanMordkin_&_OtherFactionHighElves_&_Negative	wh2_main_sc_skv_skaven
diplomacy_FactionGroup_SKV_Warlord_Faction_ClanMordkin_&_OtherFactionHighElves_&_Positive	wh2_main_sc_skv_skaven
diplomacy_FactionGroup_SKV_Warlord_Faction_ClanMordkin_&_OtherFactionLizardmen	wh2_main_sc_skv_skaven
diplomacy_FactionGroup_SKV_Warlord_Faction_ClanMordkin_&_OtherFactionLizardmen_&_Negative	wh2_main_sc_skv_skaven
diplomacy_FactionGroup_SKV_Warlord_Faction_ClanMordkin_&_OtherFactionLizardmen_&_Positive	wh2_main_sc_skv_skaven
diplomacy_FactionGroup_SKV_Warlord_Faction_ClanMordkin_&_OtherFactionSkaven	wh2_main_sc_skv_skaven
diplomacy_FactionGroup_SKV_Warlord_Faction_ClanMordkin_&_OtherFactionSkaven_&_Negative	wh2_main_sc_skv_skaven
diplomacy_FactionGroup_SKV_Warlord_Faction_ClanMordkin_&_OtherFactionSkaven_&_Positive	wh2_main_sc_skv_skaven
diplomacy_FactionGroup_SKV_Warlord_Faction_ClanMordkin_&_OtherFactionVamp	wh2_main_sc_skv_skaven
diplomacy_FactionGroup_SKV_Warlord_Faction_ClanMordkin_&_OtherFactionVamp_&_Negative	wh2_main_sc_skv_skaven
diplomacy_FactionGroup_SKV_Warlord_Faction_ClanMordkin_&_OtherFactionVamp_&_Positive	wh2_main_sc_skv_skaven
diplomacy_FactionGroup_SKV_Warlord_Faction_ClanMordkin_&_OtherFactionWoodElves	wh2_main_sc_skv_skaven
diplomacy_FactionGroup_SKV_Warlord_Faction_ClanMordkin_&_OtherFactionWoodElves_&_Negative	wh2_main_sc_skv_skaven
diplomacy_FactionGroup_SKV_Warlord_Faction_ClanMordkin_&_OtherFactionWoodElves_&_Positive	wh2_main_sc_skv_skaven
diplomacy_FactionGroup_SKV_Warlord_Faction_ClanMordkin_&_Positive	wh2_main_sc_skv_skaven
diplomacy_FactionGroup_SKV_Warlord_Faction_ClanSeptik	wh2_main_sc_skv_skaven
diplomacy_FactionGroup_SKV_Warlord_Faction_ClanSeptik_&_Negative	wh2_main_sc_skv_skaven
diplomacy_FactionGroup_SKV_Warlord_Faction_ClanSeptik_&_OtherFactionBeastmen	wh2_main_sc_skv_skaven
diplomacy_FactionGroup_SKV_Warlord_Faction_ClanSeptik_&_OtherFactionBeastmen_&_Negative	wh2_main_sc_skv_skaven
diplomacy_FactionGroup_SKV_Warlord_Faction_ClanSeptik_&_OtherFactionBeastmen_&_Positive	wh2_main_sc_skv_skaven
diplomacy_FactionGroup_SKV_Warlord_Faction_ClanSeptik_&_OtherFactionBretonnia	wh2_main_sc_skv_skaven
diplomacy_FactionGroup_SKV_Warlord_Faction_ClanSeptik_&_OtherFactionBretonnia_&_Negative	wh2_main_sc_skv_skaven
diplomacy_FactionGroup_SKV_Warlord_Faction_ClanSeptik_&_OtherFactionBretonnia_&_Positive	wh2_main_sc_skv_skaven
diplomacy_FactionGroup_SKV_Warlord_Faction_ClanSeptik_&_OtherFactionChaos	wh2_main_sc_skv_skaven
diplomacy_FactionGroup_SKV_Warlord_Faction_ClanSeptik_&_OtherFactionChaos_&_Negative	wh2_main_sc_skv_skaven
diplomacy_FactionGroup_SKV_Warlord_Faction_ClanSeptik_&_OtherFactionChaos_&_Positive	wh2_main_sc_skv_skaven
diplomacy_FactionGroup_SKV_Warlord_Faction_ClanSeptik_&_OtherFactionDarkElves	wh2_main_sc_skv_skaven
diplomacy_FactionGroup_SKV_Warlord_Faction_ClanSeptik_&_OtherFactionDarkElves_&_Negative	wh2_main_sc_skv_skaven
diplomacy_FactionGroup_SKV_Warlord_Faction_ClanSeptik_&_OtherFactionDarkElves_&_Positive	wh2_main_sc_skv_skaven
diplomacy_FactionGroup_SKV_Warlord_Faction_ClanSeptik_&_OtherFactionDwarf	wh2_main_sc_skv_skaven
diplomacy_FactionGroup_SKV_Warlord_Faction_ClanSeptik_&_OtherFactionDwarf_&_Negative	wh2_main_sc_skv_skaven
diplomacy_FactionGroup_SKV_Warlord_Faction_ClanSeptik_&_OtherFactionDwarf_&_Positive	wh2_main_sc_skv_skaven
diplomacy_FactionGroup_SKV_Warlord_Faction_ClanSeptik_&_OtherFactionEmpire	wh2_main_sc_skv_skaven
diplomacy_FactionGroup_SKV_Warlord_Faction_ClanSeptik_&_OtherFactionEmpire_&_Negative	wh2_main_sc_skv_skaven
diplomacy_FactionGroup_SKV_Warlord_Faction_ClanSeptik_&_OtherFactionEmpire_&_Positive	wh2_main_sc_skv_skaven
diplomacy_FactionGroup_SKV_Warlord_Faction_ClanSeptik_&_OtherFactionGreenskin	wh2_main_sc_skv_skaven
diplomacy_FactionGroup_SKV_Warlord_Faction_ClanSeptik_&_OtherFactionGreenskin_&_Negative	wh2_main_sc_skv_skaven
diplomacy_FactionGroup_SKV_Warlord_Faction_ClanSeptik_&_OtherFactionGreenskin_&_Positive	wh2_main_sc_skv_skaven
diplomacy_FactionGroup_SKV_Warlord_Faction_ClanSeptik_&_OtherFactionHighElves	wh2_main_sc_skv_skaven
diplomacy_FactionGroup_SKV_Warlord_Faction_ClanSeptik_&_OtherFactionHighElves_&_Negative	wh2_main_sc_skv_skaven
diplomacy_FactionGroup_SKV_Warlord_Faction_ClanSeptik_&_OtherFactionHighElves_&_Positive	wh2_main_sc_skv_skaven
diplomacy_FactionGroup_SKV_Warlord_Faction_ClanSeptik_&_OtherFactionLizardmen	wh2_main_sc_skv_skaven
diplomacy_FactionGroup_SKV_Warlord_Faction_ClanSeptik_&_OtherFactionLizardmen_&_Negative	wh2_main_sc_skv_skaven
diplomacy_FactionGroup_SKV_Warlord_Faction_ClanSeptik_&_OtherFactionLizardmen_&_Positive	wh2_main_sc_skv_skaven
diplomacy_FactionGroup_SKV_Warlord_Faction_ClanSeptik_&_OtherFactionSkaven	wh2_main_sc_skv_skaven
diplomacy_FactionGroup_SKV_Warlord_Faction_ClanSeptik_&_OtherFactionSkaven_&_Negative	wh2_main_sc_skv_skaven
diplomacy_FactionGroup_SKV_Warlord_Faction_ClanSeptik_&_OtherFactionSkaven_&_Positive	wh2_main_sc_skv_skaven
diplomacy_FactionGroup_SKV_Warlord_Faction_ClanSeptik_&_OtherFactionVamp	wh2_main_sc_skv_skaven
diplomacy_FactionGroup_SKV_Warlord_Faction_ClanSeptik_&_OtherFactionVamp_&_Negative	wh2_main_sc_skv_skaven
diplomacy_FactionGroup_SKV_Warlord_Faction_ClanSeptik_&_OtherFactionVamp_&_Positive	wh2_main_sc_skv_skaven
diplomacy_FactionGroup_SKV_Warlord_Faction_ClanSeptik_&_OtherFactionWoodElves	wh2_main_sc_skv_skaven
diplomacy_FactionGroup_SKV_Warlord_Faction_ClanSeptik_&_OtherFactionWoodElves_&_Negative	wh2_main_sc_skv_skaven
diplomacy_FactionGroup_SKV_Warlord_Faction_ClanSeptik_&_OtherFactionWoodElves_&_Positive	wh2_main_sc_skv_skaven
diplomacy_FactionGroup_SKV_Warlord_Faction_ClanSeptik_&_Positive	wh2_main_sc_skv_skaven
diplomacy_FactionGroup_SKV_Warlord_Faction_ClanSpittel	wh2_main_sc_skv_skaven
diplomacy_FactionGroup_SKV_Warlord_Faction_ClanSpittel_&_Negative	wh2_main_sc_skv_skaven
diplomacy_FactionGroup_SKV_Warlord_Faction_ClanSpittel_&_OtherFactionBeastmen	wh2_main_sc_skv_skaven
diplomacy_FactionGroup_SKV_Warlord_Faction_ClanSpittel_&_OtherFactionBeastmen_&_Negative	wh2_main_sc_skv_skaven
diplomacy_FactionGroup_SKV_Warlord_Faction_ClanSpittel_&_OtherFactionBeastmen_&_Positive	wh2_main_sc_skv_skaven
diplomacy_FactionGroup_SKV_Warlord_Faction_ClanSpittel_&_OtherFactionBretonnia	wh2_main_sc_skv_skaven
diplomacy_FactionGroup_SKV_Warlord_Faction_ClanSpittel_&_OtherFactionBretonnia_&_Negative	wh2_main_sc_skv_skaven
diplomacy_FactionGroup_SKV_Warlord_Faction_ClanSpittel_&_OtherFactionBretonnia_&_Positive	wh2_main_sc_skv_skaven
diplomacy_FactionGroup_SKV_Warlord_Faction_ClanSpittel_&_OtherFactionChaos	wh2_main_sc_skv_skaven
diplomacy_FactionGroup_SKV_Warlord_Faction_ClanSpittel_&_OtherFactionChaos_&_Negative	wh2_main_sc_skv_skaven
diplomacy_FactionGroup_SKV_Warlord_Faction_ClanSpittel_&_OtherFactionChaos_&_Positive	wh2_main_sc_skv_skaven
diplomacy_FactionGroup_SKV_Warlord_Faction_ClanSpittel_&_OtherFactionDarkElves	wh2_main_sc_skv_skaven
diplomacy_FactionGroup_SKV_Warlord_Faction_ClanSpittel_&_OtherFactionDarkElves_&_Negative	wh2_main_sc_skv_skaven
diplomacy_FactionGroup_SKV_Warlord_Faction_ClanSpittel_&_OtherFactionDarkElves_&_Positive	wh2_main_sc_skv_skaven
diplomacy_FactionGroup_SKV_Warlord_Faction_ClanSpittel_&_OtherFactionDwarf	wh2_main_sc_skv_skaven
diplomacy_FactionGroup_SKV_Warlord_Faction_ClanSpittel_&_OtherFactionDwarf_&_Negative	wh2_main_sc_skv_skaven
diplomacy_FactionGroup_SKV_Warlord_Faction_ClanSpittel_&_OtherFactionDwarf_&_Positive	wh2_main_sc_skv_skaven
diplomacy_FactionGroup_SKV_Warlord_Faction_ClanSpittel_&_OtherFactionEmpire	wh2_main_sc_skv_skaven
diplomacy_FactionGroup_SKV_Warlord_Faction_ClanSpittel_&_OtherFactionEmpire_&_Negative	wh2_main_sc_skv_skaven
diplomacy_FactionGroup_SKV_Warlord_Faction_ClanSpittel_&_OtherFactionEmpire_&_Positive	wh2_main_sc_skv_skaven
diplomacy_FactionGroup_SKV_Warlord_Faction_ClanSpittel_&_OtherFactionGreenskin	wh2_main_sc_skv_skaven
diplomacy_FactionGroup_SKV_Warlord_Faction_ClanSpittel_&_OtherFactionGreenskin_&_Negative	wh2_main_sc_skv_skaven
diplomacy_FactionGroup_SKV_Warlord_Faction_ClanSpittel_&_OtherFactionGreenskin_&_Positive	wh2_main_sc_skv_skaven
diplomacy_FactionGroup_SKV_Warlord_Faction_ClanSpittel_&_OtherFactionHighElves	wh2_main_sc_skv_skaven
diplomacy_FactionGroup_SKV_Warlord_Faction_ClanSpittel_&_OtherFactionHighElves_&_Negative	wh2_main_sc_skv_skaven
diplomacy_FactionGroup_SKV_Warlord_Faction_ClanSpittel_&_OtherFactionHighElves_&_Positive	wh2_main_sc_skv_skaven
diplomacy_FactionGroup_SKV_Warlord_Faction_ClanSpittel_&_OtherFactionLizardmen	wh2_main_sc_skv_skaven
diplomacy_FactionGroup_SKV_Warlord_Faction_ClanSpittel_&_OtherFactionLizardmen_&_Negative	wh2_main_sc_skv_skaven
diplomacy_FactionGroup_SKV_Warlord_Faction_ClanSpittel_&_OtherFactionLizardmen_&_Positive	wh2_main_sc_skv_skaven
diplomacy_FactionGroup_SKV_Warlord_Faction_ClanSpittel_&_OtherFactionSkaven	wh2_main_sc_skv_skaven
diplomacy_FactionGroup_SKV_Warlord_Faction_ClanSpittel_&_OtherFactionSkaven_&_Negative	wh2_main_sc_skv_skaven
diplomacy_FactionGroup_SKV_Warlord_Faction_ClanSpittel_&_OtherFactionSkaven_&_Positive	wh2_main_sc_skv_skaven
diplomacy_FactionGroup_SKV_Warlord_Faction_ClanSpittel_&_OtherFactionVamp	wh2_main_sc_skv_skaven
diplomacy_FactionGroup_SKV_Warlord_Faction_ClanSpittel_&_OtherFactionVamp_&_Negative	wh2_main_sc_skv_skaven
diplomacy_FactionGroup_SKV_Warlord_Faction_ClanSpittel_&_OtherFactionVamp_&_Positive	wh2_main_sc_skv_skaven
diplomacy_FactionGroup_SKV_Warlord_Faction_ClanSpittel_&_OtherFactionWoodElves	wh2_main_sc_skv_skaven
diplomacy_FactionGroup_SKV_Warlord_Faction_ClanSpittel_&_OtherFactionWoodElves_&_Negative	wh2_main_sc_skv_skaven
diplomacy_FactionGroup_SKV_Warlord_Faction_ClanSpittel_&_OtherFactionWoodElves_&_Positive	wh2_main_sc_skv_skaven
diplomacy_FactionGroup_SKV_Warlord_Faction_ClanSpittel_&_Positive	wh2_main_sc_skv_skaven
diplomacy_Subcult_Bretonnia	wh_main_sc_brt_bretonnia
diplomacy_Subcult_Bretonnia_&_Negative	wh_main_sc_brt_bretonnia
diplomacy_Subcult_Bretonnia_&_OtherFactionBretonnia	wh_main_sc_brt_bretonnia
diplomacy_Subcult_Bretonnia_&_OtherFactionBretonnia_&_Negative	wh_main_sc_brt_bretonnia
diplomacy_Subcult_Bretonnia_&_OtherFactionBretonnia_&_Positive	wh_main_sc_brt_bretonnia
diplomacy_Subcult_Bretonnia_&_OtherFactionChaos	wh_main_sc_brt_bretonnia
diplomacy_Subcult_Bretonnia_&_OtherFactionChaos_&_Negative	wh_main_sc_brt_bretonnia
diplomacy_Subcult_Bretonnia_&_OtherFactionChaos_&_Positive	wh_main_sc_brt_bretonnia
diplomacy_Subcult_Bretonnia_&_OtherFactionDwarf	wh_main_sc_brt_bretonnia
diplomacy_Subcult_Bretonnia_&_OtherFactionDwarf_&_Negative	wh_main_sc_brt_bretonnia
diplomacy_Subcult_Bretonnia_&_OtherFactionDwarf_&_Positive	wh_main_sc_brt_bretonnia
diplomacy_Subcult_Bretonnia_&_OtherFactionEmpire	wh_main_sc_brt_bretonnia
diplomacy_Subcult_Bretonnia_&_OtherFactionEmpire_&_Negative	wh_main_sc_brt_bretonnia
diplomacy_Subcult_Bretonnia_&_OtherFactionEmpire_&_Positive	wh_main_sc_brt_bretonnia
diplomacy_Subcult_Bretonnia_&_OtherFactionGreenskin	wh_main_sc_brt_bretonnia
diplomacy_Subcult_Bretonnia_&_OtherFactionGreenskin_&_Negative	wh_main_sc_brt_bretonnia
diplomacy_Subcult_Bretonnia_&_OtherFactionGreenskin_&_Positive	wh_main_sc_brt_bretonnia
diplomacy_Subcult_Bretonnia_&_OtherFactionVamp	wh_main_sc_brt_bretonnia
diplomacy_Subcult_Bretonnia_&_OtherFactionVamp_&_Negative	wh_main_sc_brt_bretonnia
diplomacy_Subcult_Bretonnia_&_OtherFactionVamp_&_Positive	wh_main_sc_brt_bretonnia
diplomacy_Subcult_Bretonnia_&_Positive	wh_main_sc_brt_bretonnia
diplomacy_Subcult_Chaos	wh_main_sc_chs_chaos
diplomacy_Subcult_Chaos_&_Negative	wh_main_sc_chs_chaos
diplomacy_Subcult_Chaos_&_OtherFactionBretonnia	wh_main_sc_chs_chaos
diplomacy_Subcult_Chaos_&_OtherFactionBretonnia_&_Negative	wh_main_sc_chs_chaos
diplomacy_Subcult_Chaos_&_OtherFactionBretonnia_&_Positive	wh_main_sc_chs_chaos
diplomacy_Subcult_Chaos_&_OtherFactionChaos	wh_main_sc_chs_chaos
diplomacy_Subcult_Chaos_&_OtherFactionChaos_&_Negative	wh_main_sc_chs_chaos
diplomacy_Subcult_Chaos_&_OtherFactionChaos_&_Positive	wh_main_sc_chs_chaos
diplomacy_Subcult_Chaos_&_OtherFactionDwarf	wh_main_sc_chs_chaos
diplomacy_Subcult_Chaos_&_OtherFactionDwarf_&_Negative	wh_main_sc_chs_chaos
diplomacy_Subcult_Chaos_&_OtherFactionDwarf_&_Positive	wh_main_sc_chs_chaos
diplomacy_Subcult_Chaos_&_OtherFactionEmpire	wh_main_sc_chs_chaos
diplomacy_Subcult_Chaos_&_OtherFactionEmpire_&_Negative	wh_main_sc_chs_chaos
diplomacy_Subcult_Chaos_&_OtherFactionEmpire_&_Positive	wh_main_sc_chs_chaos
diplomacy_Subcult_Chaos_&_OtherFactionGreenskin	wh_main_sc_chs_chaos
diplomacy_Subcult_Chaos_&_OtherFactionGreenskin_&_Negative	wh_main_sc_chs_chaos
diplomacy_Subcult_Chaos_&_OtherFactionGreenskin_&_Positive	wh_main_sc_chs_chaos
diplomacy_Subcult_Chaos_&_OtherFactionVamp	wh_main_sc_chs_chaos
diplomacy_Subcult_Chaos_&_OtherFactionVamp_&_Negative	wh_main_sc_chs_chaos
diplomacy_Subcult_Chaos_&_OtherFactionVamp_&_Positive	wh_main_sc_chs_chaos
diplomacy_Subcult_Chaos_&_Positive	wh_main_sc_chs_chaos
diplomacy_Subcult_DarkElves	wh2_main_sc_def_dark_elves
diplomacy_Subcult_DarkElves_&_Negative	wh2_main_sc_def_dark_elves
diplomacy_Subcult_DarkElves_&_OtherFactionBeastmen	wh2_main_sc_def_dark_elves
diplomacy_Subcult_DarkElves_&_OtherFactionBeastmen_&_Negative	wh2_main_sc_def_dark_elves
diplomacy_Subcult_DarkElves_&_OtherFactionBeastmen_&_Positive	wh2_main_sc_def_dark_elves
diplomacy_Subcult_DarkElves_&_OtherFactionBretonnia	wh2_main_sc_def_dark_elves
diplomacy_Subcult_DarkElves_&_OtherFactionBretonnia_&_Negative	wh2_main_sc_def_dark_elves
diplomacy_Subcult_DarkElves_&_OtherFactionBretonnia_&_Positive	wh2_main_sc_def_dark_elves
diplomacy_Subcult_DarkElves_&_OtherFactionChaos	wh2_main_sc_def_dark_elves
diplomacy_Subcult_DarkElves_&_OtherFactionChaos_&_Negative	wh2_main_sc_def_dark_elves
diplomacy_Subcult_DarkElves_&_OtherFactionChaos_&_Positive	wh2_main_sc_def_dark_elves
diplomacy_Subcult_DarkElves_&_OtherFactionDarkElves	wh2_main_sc_def_dark_elves
diplomacy_Subcult_DarkElves_&_OtherFactionDarkElves_&_Negative	wh2_main_sc_def_dark_elves
diplomacy_Subcult_DarkElves_&_OtherFactionDarkElves_&_Positive	wh2_main_sc_def_dark_elves
diplomacy_Subcult_DarkElves_&_OtherFactionDwarf	wh2_main_sc_def_dark_elves
diplomacy_Subcult_DarkElves_&_OtherFactionDwarf_&_Negative	wh2_main_sc_def_dark_elves
diplomacy_Subcult_DarkElves_&_OtherFactionDwarf_&_Positive	wh2_main_sc_def_dark_elves
diplomacy_Subcult_DarkElves_&_OtherFactionEmpire	wh2_main_sc_def_dark_elves
diplomacy_Subcult_DarkElves_&_OtherFactionEmpire_&_Negative	wh2_main_sc_def_dark_elves
diplomacy_Subcult_DarkElves_&_OtherFactionEmpire_&_Positive	wh2_main_sc_def_dark_elves
diplomacy_Subcult_DarkElves_&_OtherFactionGreenskin	wh2_main_sc_def_dark_elves
diplomacy_Subcult_DarkElves_&_OtherFactionGreenskin_&_Negative	wh2_main_sc_def_dark_elves
diplomacy_Subcult_DarkElves_&_OtherFactionGreenskin_&_Positive	wh2_main_sc_def_dark_elves
diplomacy_Subcult_DarkElves_&_OtherFactionHighElves	wh2_main_sc_def_dark_elves
diplomacy_Subcult_DarkElves_&_OtherFactionHighElves_&_Negative	wh2_main_sc_def_dark_elves
diplomacy_Subcult_DarkElves_&_OtherFactionHighElves_&_Positive	wh2_main_sc_def_dark_elves
diplomacy_Subcult_DarkElves_&_OtherFactionLizardmen	wh2_main_sc_def_dark_elves
diplomacy_Subcult_DarkElves_&_OtherFactionLizardmen_&_Negative	wh2_main_sc_def_dark_elves
diplomacy_Subcult_DarkElves_&_OtherFactionLizardmen_&_Positive	wh2_main_sc_def_dark_elves
diplomacy_Subcult_DarkElves_&_OtherFactionSkaven	wh2_main_sc_def_dark_elves
diplomacy_Subcult_DarkElves_&_OtherFactionSkaven_&_Negative	wh2_main_sc_def_dark_elves
diplomacy_Subcult_DarkElves_&_OtherFactionSkaven_&_Positive	wh2_main_sc_def_dark_elves
diplomacy_Subcult_DarkElves_&_OtherFactionVamp	wh2_main_sc_def_dark_elves
diplomacy_Subcult_DarkElves_&_OtherFactionVamp_&_Negative	wh2_main_sc_def_dark_elves
diplomacy_Subcult_DarkElves_&_OtherFactionVamp_&_Positive	wh2_main_sc_def_dark_elves
diplomacy_Subcult_DarkElves_&_OtherFactionWoodElves	wh2_main_sc_def_dark_elves
diplomacy_Subcult_DarkElves_&_OtherFactionWoodElves_&_Negative	wh2_main_sc_def_dark_elves
diplomacy_Subcult_DarkElves_&_OtherFactionWoodElves_&_Positive	wh2_main_sc_def_dark_elves
diplomacy_Subcult_DarkElves_&_Positive	wh2_main_sc_def_dark_elves
diplomacy_Subcult_Dwarfs	wh_main_sc_dwf_dwarfs
diplomacy_Subcult_Dwarfs_&_FactionKarakAzul_Dwarf_Lord_2	wh_main_sc_dwf_dwarfs
diplomacy_Subcult_Dwarfs_&_FactionKarakAzul_Dwarf_Lord_2_&_Negative	wh_main_sc_dwf_dwarfs
diplomacy_Subcult_Dwarfs_&_FactionKarakAzul_Dwarf_Lord_2_&_OtherFactionBretonnia	wh_main_sc_dwf_dwarfs
diplomacy_Subcult_Dwarfs_&_FactionKarakAzul_Dwarf_Lord_2_&_OtherFactionBretonnia_&_Negative	wh_main_sc_dwf_dwarfs
diplomacy_Subcult_Dwarfs_&_FactionKarakAzul_Dwarf_Lord_2_&_OtherFactionBretonnia_&_Positive	wh_main_sc_dwf_dwarfs
diplomacy_Subcult_Dwarfs_&_FactionKarakAzul_Dwarf_Lord_2_&_OtherFactionChaos	wh_main_sc_dwf_dwarfs
diplomacy_Subcult_Dwarfs_&_FactionKarakAzul_Dwarf_Lord_2_&_OtherFactionChaos_&_Negative	wh_main_sc_dwf_dwarfs
diplomacy_Subcult_Dwarfs_&_FactionKarakAzul_Dwarf_Lord_2_&_OtherFactionChaos_&_Positive	wh_main_sc_dwf_dwarfs
diplomacy_Subcult_Dwarfs_&_FactionKarakAzul_Dwarf_Lord_2_&_OtherFactionDwarf	wh_main_sc_dwf_dwarfs
diplomacy_Subcult_Dwarfs_&_FactionKarakAzul_Dwarf_Lord_2_&_OtherFactionDwarf_&_Negative	wh_main_sc_dwf_dwarfs
diplomacy_Subcult_Dwarfs_&_FactionKarakAzul_Dwarf_Lord_2_&_OtherFactionDwarf_&_Positive	wh_main_sc_dwf_dwarfs
diplomacy_Subcult_Dwarfs_&_FactionKarakAzul_Dwarf_Lord_2_&_OtherFactionEmpire	wh_main_sc_dwf_dwarfs
diplomacy_Subcult_Dwarfs_&_FactionKarakAzul_Dwarf_Lord_2_&_OtherFactionEmpire_&_Negative	wh_main_sc_dwf_dwarfs
diplomacy_Subcult_Dwarfs_&_FactionKarakAzul_Dwarf_Lord_2_&_OtherFactionEmpire_&_Positive	wh_main_sc_dwf_dwarfs
diplomacy_Subcult_Dwarfs_&_FactionKarakAzul_Dwarf_Lord_2_&_OtherFactionGreenskin	wh_main_sc_dwf_dwarfs
diplomacy_Subcult_Dwarfs_&_FactionKarakAzul_Dwarf_Lord_2_&_OtherFactionGreenskin_&_Negative	wh_main_sc_dwf_dwarfs
diplomacy_Subcult_Dwarfs_&_FactionKarakAzul_Dwarf_Lord_2_&_OtherFactionGreenskin_&_Positive	wh_main_sc_dwf_dwarfs
diplomacy_Subcult_Dwarfs_&_FactionKarakAzul_Dwarf_Lord_2_&_OtherFactionVamp	wh_main_sc_dwf_dwarfs
diplomacy_Subcult_Dwarfs_&_FactionKarakAzul_Dwarf_Lord_2_&_OtherFactionVamp_&_Negative	wh_main_sc_dwf_dwarfs
diplomacy_Subcult_Dwarfs_&_FactionKarakAzul_Dwarf_Lord_2_&_OtherFactionVamp_&_Positive	wh_main_sc_dwf_dwarfs
diplomacy_Subcult_Dwarfs_&_FactionKarakAzul_Dwarf_Lord_2_&_Positive	wh_main_sc_dwf_dwarfs
diplomacy_Subcult_Dwarfs_&_FactionKarakKadrin_Dwarf_Lord_2	wh_main_sc_dwf_dwarfs
diplomacy_Subcult_Dwarfs_&_FactionKarakKadrin_Dwarf_Lord_2_&_Negative	wh_main_sc_dwf_dwarfs
diplomacy_Subcult_Dwarfs_&_FactionKarakKadrin_Dwarf_Lord_2_&_OtherFactionBretonnia	wh_main_sc_dwf_dwarfs
diplomacy_Subcult_Dwarfs_&_FactionKarakKadrin_Dwarf_Lord_2_&_OtherFactionBretonnia_&_Negative	wh_main_sc_dwf_dwarfs
diplomacy_Subcult_Dwarfs_&_FactionKarakKadrin_Dwarf_Lord_2_&_OtherFactionBretonnia_&_Positive	wh_main_sc_dwf_dwarfs
diplomacy_Subcult_Dwarfs_&_FactionKarakKadrin_Dwarf_Lord_2_&_OtherFactionChaos	wh_main_sc_dwf_dwarfs
diplomacy_Subcult_Dwarfs_&_FactionKarakKadrin_Dwarf_Lord_2_&_OtherFactionChaos_&_Negative	wh_main_sc_dwf_dwarfs
diplomacy_Subcult_Dwarfs_&_FactionKarakKadrin_Dwarf_Lord_2_&_OtherFactionChaos_&_Positive	wh_main_sc_dwf_dwarfs
diplomacy_Subcult_Dwarfs_&_FactionKarakKadrin_Dwarf_Lord_2_&_OtherFactionDwarf	wh_main_sc_dwf_dwarfs
diplomacy_Subcult_Dwarfs_&_FactionKarakKadrin_Dwarf_Lord_2_&_OtherFactionDwarf_&_Negative	wh_main_sc_dwf_dwarfs
diplomacy_Subcult_Dwarfs_&_FactionKarakKadrin_Dwarf_Lord_2_&_OtherFactionDwarf_&_Positive	wh_main_sc_dwf_dwarfs
diplomacy_Subcult_Dwarfs_&_FactionKarakKadrin_Dwarf_Lord_2_&_OtherFactionEmpire	wh_main_sc_dwf_dwarfs
diplomacy_Subcult_Dwarfs_&_FactionKarakKadrin_Dwarf_Lord_2_&_OtherFactionEmpire_&_Negative	wh_main_sc_dwf_dwarfs
diplomacy_Subcult_Dwarfs_&_FactionKarakKadrin_Dwarf_Lord_2_&_OtherFactionEmpire_&_Positive	wh_main_sc_dwf_dwarfs
diplomacy_Subcult_Dwarfs_&_FactionKarakKadrin_Dwarf_Lord_2_&_OtherFactionGreenskin	wh_main_sc_dwf_dwarfs
diplomacy_Subcult_Dwarfs_&_FactionKarakKadrin_Dwarf_Lord_2_&_OtherFactionGreenskin_&_Negative	wh_main_sc_dwf_dwarfs
diplomacy_Subcult_Dwarfs_&_FactionKarakKadrin_Dwarf_Lord_2_&_OtherFactionGreenskin_&_Positive	wh_main_sc_dwf_dwarfs
diplomacy_Subcult_Dwarfs_&_FactionKarakKadrin_Dwarf_Lord_2_&_OtherFactionVamp	wh_main_sc_dwf_dwarfs
diplomacy_Subcult_Dwarfs_&_FactionKarakKadrin_Dwarf_Lord_2_&_OtherFactionVamp_&_Negative	wh_main_sc_dwf_dwarfs
diplomacy_Subcult_Dwarfs_&_FactionKarakKadrin_Dwarf_Lord_2_&_OtherFactionVamp_&_Positive	wh_main_sc_dwf_dwarfs
diplomacy_Subcult_Dwarfs_&_FactionKarakKadrin_Dwarf_Lord_2_&_Positive	wh_main_sc_dwf_dwarfs
diplomacy_Subcult_Dwarfs_&_Negative	wh_main_sc_dwf_dwarfs
diplomacy_Subcult_Dwarfs_&_OtherFactionBretonnia	wh_main_sc_dwf_dwarfs
diplomacy_Subcult_Dwarfs_&_OtherFactionBretonnia_&_Negative	wh_main_sc_dwf_dwarfs
diplomacy_Subcult_Dwarfs_&_OtherFactionBretonnia_&_Positive	wh_main_sc_dwf_dwarfs
diplomacy_Subcult_Dwarfs_&_OtherFactionChaos	wh_main_sc_dwf_dwarfs
diplomacy_Subcult_Dwarfs_&_OtherFactionChaos_&_Negative	wh_main_sc_dwf_dwarfs
diplomacy_Subcult_Dwarfs_&_OtherFactionChaos_&_Positive	wh_main_sc_dwf_dwarfs
diplomacy_Subcult_Dwarfs_&_OtherFactionDwarf	wh_main_sc_dwf_dwarfs
diplomacy_Subcult_Dwarfs_&_OtherFactionDwarf_&_Negative	wh_main_sc_dwf_dwarfs
diplomacy_Subcult_Dwarfs_&_OtherFactionDwarf_&_Positive	wh_main_sc_dwf_dwarfs
diplomacy_Subcult_Dwarfs_&_OtherFactionEmpire	wh_main_sc_dwf_dwarfs
diplomacy_Subcult_Dwarfs_&_OtherFactionEmpire_&_Negative	wh_main_sc_dwf_dwarfs
diplomacy_Subcult_Dwarfs_&_OtherFactionEmpire_&_Positive	wh_main_sc_dwf_dwarfs
diplomacy_Subcult_Dwarfs_&_OtherFactionGreenskin	wh_main_sc_dwf_dwarfs
diplomacy_Subcult_Dwarfs_&_OtherFactionGreenskin_&_Negative	wh_main_sc_dwf_dwarfs
diplomacy_Subcult_Dwarfs_&_OtherFactionGreenskin_&_Positive	wh_main_sc_dwf_dwarfs
diplomacy_Subcult_Dwarfs_&_OtherFactionVamp	wh_main_sc_dwf_dwarfs
diplomacy_Subcult_Dwarfs_&_OtherFactionVamp_&_Negative	wh_main_sc_dwf_dwarfs
diplomacy_Subcult_Dwarfs_&_OtherFactionVamp_&_Positive	wh_main_sc_dwf_dwarfs
diplomacy_Subcult_Dwarfs_&_Positive	wh_main_sc_dwf_dwarfs
diplomacy_Subcult_Empire	wh_main_sc_emp_empire
diplomacy_Subcult_Empire_&_FactionAverland_Emp_General_2	wh_main_sc_emp_empire
diplomacy_Subcult_Empire_&_FactionAverland_Emp_General_2_Negative	wh_main_sc_emp_empire
diplomacy_Subcult_Empire_&_FactionAverland_Emp_General_2_OtherFactionBretonnia	wh_main_sc_emp_empire
diplomacy_Subcult_Empire_&_FactionAverland_Emp_General_2_OtherFactionBretonnia_&_Negative	wh_main_sc_emp_empire
diplomacy_Subcult_Empire_&_FactionAverland_Emp_General_2_OtherFactionBretonnia_&_Positive	wh_main_sc_emp_empire
diplomacy_Subcult_Empire_&_FactionAverland_Emp_General_2_OtherFactionChaos	wh_main_sc_emp_empire
diplomacy_Subcult_Empire_&_FactionAverland_Emp_General_2_OtherFactionChaos_&_Negative	wh_main_sc_emp_empire
diplomacy_Subcult_Empire_&_FactionAverland_Emp_General_2_OtherFactionChaos_&_Positive	wh_main_sc_emp_empire
diplomacy_Subcult_Empire_&_FactionAverland_Emp_General_2_OtherFactionDwarf	wh_main_sc_emp_empire
diplomacy_Subcult_Empire_&_FactionAverland_Emp_General_2_OtherFactionDwarf_&_Negative	wh_main_sc_emp_empire
diplomacy_Subcult_Empire_&_FactionAverland_Emp_General_2_OtherFactionDwarf_&_Positive	wh_main_sc_emp_empire
diplomacy_Subcult_Empire_&_FactionAverland_Emp_General_2_OtherFactionEmpire	wh_main_sc_emp_empire
diplomacy_Subcult_Empire_&_FactionAverland_Emp_General_2_OtherFactionEmpire_&_Negative	wh_main_sc_emp_empire
diplomacy_Subcult_Empire_&_FactionAverland_Emp_General_2_OtherFactionEmpire_&_Positive	wh_main_sc_emp_empire
diplomacy_Subcult_Empire_&_FactionAverland_Emp_General_2_OtherFactionGreenskin	wh_main_sc_emp_empire
diplomacy_Subcult_Empire_&_FactionAverland_Emp_General_2_OtherFactionGreenskin_&_Negative	wh_main_sc_emp_empire
diplomacy_Subcult_Empire_&_FactionAverland_Emp_General_2_OtherFactionGreenskin_&_Positive	wh_main_sc_emp_empire
diplomacy_Subcult_Empire_&_FactionAverland_Emp_General_2_OtherFactionVamp	wh_main_sc_emp_empire
diplomacy_Subcult_Empire_&_FactionAverland_Emp_General_2_OtherFactionVamp_&_Negative	wh_main_sc_emp_empire
diplomacy_Subcult_Empire_&_FactionAverland_Emp_General_2_OtherFactionVamp_&_Positive	wh_main_sc_emp_empire
diplomacy_Subcult_Empire_&_FactionAverland_Emp_General_2_Positive	wh_main_sc_emp_empire
diplomacy_Subcult_Empire_&_FactionMarienburg_Emp_General_2	wh_main_sc_emp_empire
diplomacy_Subcult_Empire_&_FactionMarienburg_Emp_General_2_Negative	wh_main_sc_emp_empire
diplomacy_Subcult_Empire_&_FactionMarienburg_Emp_General_2_OtherFactionBretonnia	wh_main_sc_emp_empire
diplomacy_Subcult_Empire_&_FactionMarienburg_Emp_General_2_OtherFactionBretonnia_&_Negative	wh_main_sc_emp_empire
diplomacy_Subcult_Empire_&_FactionMarienburg_Emp_General_2_OtherFactionBretonnia_&_Positive	wh_main_sc_emp_empire
diplomacy_Subcult_Empire_&_FactionMarienburg_Emp_General_2_OtherFactionChaos	wh_main_sc_emp_empire
diplomacy_Subcult_Empire_&_FactionMarienburg_Emp_General_2_OtherFactionChaos_&_Negative	wh_main_sc_emp_empire
diplomacy_Subcult_Empire_&_FactionMarienburg_Emp_General_2_OtherFactionChaos_&_Positive	wh_main_sc_emp_empire
diplomacy_Subcult_Empire_&_FactionMarienburg_Emp_General_2_OtherFactionDwarf	wh_main_sc_emp_empire
diplomacy_Subcult_Empire_&_FactionMarienburg_Emp_General_2_OtherFactionDwarf_&_Negative	wh_main_sc_emp_empire
diplomacy_Subcult_Empire_&_FactionMarienburg_Emp_General_2_OtherFactionDwarf_&_Positive	wh_main_sc_emp_empire
diplomacy_Subcult_Empire_&_FactionMarienburg_Emp_General_2_OtherFactionEmpire	wh_main_sc_emp_empire
diplomacy_Subcult_Empire_&_FactionMarienburg_Emp_General_2_OtherFactionEmpire_&_Negative	wh_main_sc_emp_empire
diplomacy_Subcult_Empire_&_FactionMarienburg_Emp_General_2_OtherFactionEmpire_&_Positive	wh_main_sc_emp_empire
diplomacy_Subcult_Empire_&_FactionMarienburg_Emp_General_2_OtherFactionGreenskin	wh_main_sc_emp_empire
diplomacy_Subcult_Empire_&_FactionMarienburg_Emp_General_2_OtherFactionGreenskin_&_Negative	wh_main_sc_emp_empire
diplomacy_Subcult_Empire_&_FactionMarienburg_Emp_General_2_OtherFactionGreenskin_&_Positive	wh_main_sc_emp_empire
diplomacy_Subcult_Empire_&_FactionMarienburg_Emp_General_2_OtherFactionVamp	wh_main_sc_emp_empire
diplomacy_Subcult_Empire_&_FactionMarienburg_Emp_General_2_OtherFactionVamp_&_Negative	wh_main_sc_emp_empire
diplomacy_Subcult_Empire_&_FactionMarienburg_Emp_General_2_OtherFactionVamp_&_Positive	wh_main_sc_emp_empire
diplomacy_Subcult_Empire_&_FactionMarienburg_Emp_General_2_Positive	wh_main_sc_emp_empire
diplomacy_Subcult_Empire_&_FactionTalabecland_Emp_General_2	wh_main_sc_emp_empire
diplomacy_Subcult_Empire_&_FactionTalabecland_Emp_General_2_Negative	wh_main_sc_emp_empire
diplomacy_Subcult_Empire_&_FactionTalabecland_Emp_General_2_OtherFactionBretonnia	wh_main_sc_emp_empire
diplomacy_Subcult_Empire_&_FactionTalabecland_Emp_General_2_OtherFactionBretonnia_&_Negative	wh_main_sc_emp_empire
diplomacy_Subcult_Empire_&_FactionTalabecland_Emp_General_2_OtherFactionBretonnia_&_Positive	wh_main_sc_emp_empire
diplomacy_Subcult_Empire_&_FactionTalabecland_Emp_General_2_OtherFactionChaos	wh_main_sc_emp_empire
diplomacy_Subcult_Empire_&_FactionTalabecland_Emp_General_2_OtherFactionChaos_&_Negative	wh_main_sc_emp_empire
diplomacy_Subcult_Empire_&_FactionTalabecland_Emp_General_2_OtherFactionChaos_&_Positive	wh_main_sc_emp_empire
diplomacy_Subcult_Empire_&_FactionTalabecland_Emp_General_2_OtherFactionDwarf	wh_main_sc_emp_empire
diplomacy_Subcult_Empire_&_FactionTalabecland_Emp_General_2_OtherFactionDwarf_&_Negative	wh_main_sc_emp_empire
diplomacy_Subcult_Empire_&_FactionTalabecland_Emp_General_2_OtherFactionDwarf_&_Positive	wh_main_sc_emp_empire
diplomacy_Subcult_Empire_&_FactionTalabecland_Emp_General_2_OtherFactionEmpire	wh_main_sc_emp_empire
diplomacy_Subcult_Empire_&_FactionTalabecland_Emp_General_2_OtherFactionEmpire_&_Negative	wh_main_sc_emp_empire
diplomacy_Subcult_Empire_&_FactionTalabecland_Emp_General_2_OtherFactionEmpire_&_Positive	wh_main_sc_emp_empire
diplomacy_Subcult_Empire_&_FactionTalabecland_Emp_General_2_OtherFactionGreenskin	wh_main_sc_emp_empire
diplomacy_Subcult_Empire_&_FactionTalabecland_Emp_General_2_OtherFactionGreenskin_&_Negative	wh_main_sc_emp_empire
diplomacy_Subcult_Empire_&_FactionTalabecland_Emp_General_2_OtherFactionGreenskin_&_Positive	wh_main_sc_emp_empire
diplomacy_Subcult_Empire_&_FactionTalabecland_Emp_General_2_OtherFactionVamp	wh_main_sc_emp_empire
diplomacy_Subcult_Empire_&_FactionTalabecland_Emp_General_2_OtherFactionVamp_&_Negative	wh_main_sc_emp_empire
diplomacy_Subcult_Empire_&_FactionTalabecland_Emp_General_2_OtherFactionVamp_&_Positive	wh_main_sc_emp_empire
diplomacy_Subcult_Empire_&_FactionTalabecland_Emp_General_2_Positive	wh_main_sc_emp_empire
diplomacy_Subcult_Empire_&_Negative	wh_main_sc_emp_empire
diplomacy_Subcult_Empire_&_OtherFactionBretonnia	wh_main_sc_emp_empire
diplomacy_Subcult_Empire_&_OtherFactionBretonnia_&_Negative	wh_main_sc_emp_empire
diplomacy_Subcult_Empire_&_OtherFactionBretonnia_&_Positive	wh_main_sc_emp_empire
diplomacy_Subcult_Empire_&_OtherFactionChaos	wh_main_sc_emp_empire
diplomacy_Subcult_Empire_&_OtherFactionChaos_&_Negative	wh_main_sc_emp_empire
diplomacy_Subcult_Empire_&_OtherFactionChaos_&_Positive	wh_main_sc_emp_empire
diplomacy_Subcult_Empire_&_OtherFactionDwarf	wh_main_sc_emp_empire
diplomacy_Subcult_Empire_&_OtherFactionDwarf_&_Negative	wh_main_sc_emp_empire
diplomacy_Subcult_Empire_&_OtherFactionDwarf_&_Positive	wh_main_sc_emp_empire
diplomacy_Subcult_Empire_&_OtherFactionEmpire	wh_main_sc_emp_empire
diplomacy_Subcult_Empire_&_OtherFactionEmpire_&_Negative	wh_main_sc_emp_empire
diplomacy_Subcult_Empire_&_OtherFactionEmpire_&_Positive	wh_main_sc_emp_empire
diplomacy_Subcult_Empire_&_OtherFactionGreenskin	wh_main_sc_emp_empire
diplomacy_Subcult_Empire_&_OtherFactionGreenskin_&_Negative	wh_main_sc_emp_empire
diplomacy_Subcult_Empire_&_OtherFactionGreenskin_&_Positive	wh_main_sc_emp_empire
diplomacy_Subcult_Empire_&_OtherFactionVamp	wh_main_sc_emp_empire
diplomacy_Subcult_Empire_&_OtherFactionVamp_&_Negative	wh_main_sc_emp_empire
diplomacy_Subcult_Empire_&_OtherFactionVamp_&_Positive	wh_main_sc_emp_empire
diplomacy_Subcult_Empire_&_Positive	wh_main_sc_emp_empire
diplomacy_Subcult_Greenskins	wh_main_sc_grn_greenskins
diplomacy_Subcult_Greenskins_&_FactionBlackPit_Goblin_Great_Shaman_1	wh_main_sc_grn_greenskins
diplomacy_Subcult_Greenskins_&_FactionBlackPit_Goblin_Great_Shaman_1_&_Negative	wh_main_sc_grn_greenskins
diplomacy_Subcult_Greenskins_&_FactionBlackPit_Goblin_Great_Shaman_1_&_OtherFactionBretonnia	wh_main_sc_grn_greenskins
diplomacy_Subcult_Greenskins_&_FactionBlackPit_Goblin_Great_Shaman_1_&_OtherFactionBretonnia_&_Negative	wh_main_sc_grn_greenskins
diplomacy_Subcult_Greenskins_&_FactionBlackPit_Goblin_Great_Shaman_1_&_OtherFactionBretonnia_&_Positive	wh_main_sc_grn_greenskins
diplomacy_Subcult_Greenskins_&_FactionBlackPit_Goblin_Great_Shaman_1_&_OtherFactionChaos	wh_main_sc_grn_greenskins
diplomacy_Subcult_Greenskins_&_FactionBlackPit_Goblin_Great_Shaman_1_&_OtherFactionChaos_&_Negative	wh_main_sc_grn_greenskins
diplomacy_Subcult_Greenskins_&_FactionBlackPit_Goblin_Great_Shaman_1_&_OtherFactionChaos_&_Positive	wh_main_sc_grn_greenskins
diplomacy_Subcult_Greenskins_&_FactionBlackPit_Goblin_Great_Shaman_1_&_OtherFactionDwarf	wh_main_sc_grn_greenskins
diplomacy_Subcult_Greenskins_&_FactionBlackPit_Goblin_Great_Shaman_1_&_OtherFactionDwarf_&_Negative	wh_main_sc_grn_greenskins
diplomacy_Subcult_Greenskins_&_FactionBlackPit_Goblin_Great_Shaman_1_&_OtherFactionDwarf_&_Positive	wh_main_sc_grn_greenskins
diplomacy_Subcult_Greenskins_&_FactionBlackPit_Goblin_Great_Shaman_1_&_OtherFactionEmpire	wh_main_sc_grn_greenskins
diplomacy_Subcult_Greenskins_&_FactionBlackPit_Goblin_Great_Shaman_1_&_OtherFactionEmpire_&_Negative	wh_main_sc_grn_greenskins
diplomacy_Subcult_Greenskins_&_FactionBlackPit_Goblin_Great_Shaman_1_&_OtherFactionEmpire_&_Positive	wh_main_sc_grn_greenskins
diplomacy_Subcult_Greenskins_&_FactionBlackPit_Goblin_Great_Shaman_1_&_OtherFactionGreenskin	wh_main_sc_grn_greenskins
diplomacy_Subcult_Greenskins_&_FactionBlackPit_Goblin_Great_Shaman_1_&_OtherFactionGreenskin_&_Negative	wh_main_sc_grn_greenskins
diplomacy_Subcult_Greenskins_&_FactionBlackPit_Goblin_Great_Shaman_1_&_OtherFactionGreenskin_&_Positive	wh_main_sc_grn_greenskins
diplomacy_Subcult_Greenskins_&_FactionBlackPit_Goblin_Great_Shaman_1_&_OtherFactionVamp	wh_main_sc_grn_greenskins
diplomacy_Subcult_Greenskins_&_FactionBlackPit_Goblin_Great_Shaman_1_&_OtherFactionVamp_&_Negative	wh_main_sc_grn_greenskins
diplomacy_Subcult_Greenskins_&_FactionBlackPit_Goblin_Great_Shaman_1_&_OtherFactionVamp_&_Positive	wh_main_sc_grn_greenskins
diplomacy_Subcult_Greenskins_&_FactionBlackPit_Goblin_Great_Shaman_1_&_Positive	wh_main_sc_grn_greenskins
diplomacy_Subcult_Greenskins_&_FactionBlackVenom_Goblin_Great_Shaman_1	wh_main_sc_grn_greenskins
diplomacy_Subcult_Greenskins_&_FactionBlackVenom_Goblin_Great_Shaman_1_&_Negative	wh_main_sc_grn_greenskins
diplomacy_Subcult_Greenskins_&_FactionBlackVenom_Goblin_Great_Shaman_1_&_OtherFactionBretonnia	wh_main_sc_grn_greenskins
diplomacy_Subcult_Greenskins_&_FactionBlackVenom_Goblin_Great_Shaman_1_&_OtherFactionBretonnia_&_Negative	wh_main_sc_grn_greenskins
diplomacy_Subcult_Greenskins_&_FactionBlackVenom_Goblin_Great_Shaman_1_&_OtherFactionBretonnia_&_Positive	wh_main_sc_grn_greenskins
diplomacy_Subcult_Greenskins_&_FactionBlackVenom_Goblin_Great_Shaman_1_&_OtherFactionChaos	wh_main_sc_grn_greenskins
diplomacy_Subcult_Greenskins_&_FactionBlackVenom_Goblin_Great_Shaman_1_&_OtherFactionChaos_&_Negative	wh_main_sc_grn_greenskins
diplomacy_Subcult_Greenskins_&_FactionBlackVenom_Goblin_Great_Shaman_1_&_OtherFactionChaos_&_Positive	wh_main_sc_grn_greenskins
diplomacy_Subcult_Greenskins_&_FactionBlackVenom_Goblin_Great_Shaman_1_&_OtherFactionDwarf	wh_main_sc_grn_greenskins
diplomacy_Subcult_Greenskins_&_FactionBlackVenom_Goblin_Great_Shaman_1_&_OtherFactionDwarf_&_Negative	wh_main_sc_grn_greenskins
diplomacy_Subcult_Greenskins_&_FactionBlackVenom_Goblin_Great_Shaman_1_&_OtherFactionDwarf_&_Positive	wh_main_sc_grn_greenskins
diplomacy_Subcult_Greenskins_&_FactionBlackVenom_Goblin_Great_Shaman_1_&_OtherFactionEmpire	wh_main_sc_grn_greenskins
diplomacy_Subcult_Greenskins_&_FactionBlackVenom_Goblin_Great_Shaman_1_&_OtherFactionEmpire_&_Negative	wh_main_sc_grn_greenskins
diplomacy_Subcult_Greenskins_&_FactionBlackVenom_Goblin_Great_Shaman_1_&_OtherFactionEmpire_&_Positive	wh_main_sc_grn_greenskins
diplomacy_Subcult_Greenskins_&_FactionBlackVenom_Goblin_Great_Shaman_1_&_OtherFactionGreenskin	wh_main_sc_grn_greenskins
diplomacy_Subcult_Greenskins_&_FactionBlackVenom_Goblin_Great_Shaman_1_&_OtherFactionGreenskin_&_Negative	wh_main_sc_grn_greenskins
diplomacy_Subcult_Greenskins_&_FactionBlackVenom_Goblin_Great_Shaman_1_&_OtherFactionGreenskin_&_Positive	wh_main_sc_grn_greenskins
diplomacy_Subcult_Greenskins_&_FactionBlackVenom_Goblin_Great_Shaman_1_&_OtherFactionVamp	wh_main_sc_grn_greenskins
diplomacy_Subcult_Greenskins_&_FactionBlackVenom_Goblin_Great_Shaman_1_&_OtherFactionVamp_&_Negative	wh_main_sc_grn_greenskins
diplomacy_Subcult_Greenskins_&_FactionBlackVenom_Goblin_Great_Shaman_1_&_OtherFactionVamp_&_Positive	wh_main_sc_grn_greenskins
diplomacy_Subcult_Greenskins_&_FactionBlackVenom_Goblin_Great_Shaman_1_&_Positive	wh_main_sc_grn_greenskins
diplomacy_Subcult_Greenskins_&_FactionCrookedMoon_Goblin_Great_Shaman_2	wh_main_sc_grn_greenskins
diplomacy_Subcult_Greenskins_&_FactionCrookedMoon_Goblin_Great_Shaman_2_&_Negative	wh_main_sc_grn_greenskins
diplomacy_Subcult_Greenskins_&_FactionCrookedMoon_Goblin_Great_Shaman_2_&_OtherFactionBretonnia	wh_main_sc_grn_greenskins
diplomacy_Subcult_Greenskins_&_FactionCrookedMoon_Goblin_Great_Shaman_2_&_OtherFactionBretonnia_&_Negative	wh_main_sc_grn_greenskins
diplomacy_Subcult_Greenskins_&_FactionCrookedMoon_Goblin_Great_Shaman_2_&_OtherFactionBretonnia_&_Positive	wh_main_sc_grn_greenskins
diplomacy_Subcult_Greenskins_&_FactionCrookedMoon_Goblin_Great_Shaman_2_&_OtherFactionChaos	wh_main_sc_grn_greenskins
diplomacy_Subcult_Greenskins_&_FactionCrookedMoon_Goblin_Great_Shaman_2_&_OtherFactionChaos_&_Negative	wh_main_sc_grn_greenskins
diplomacy_Subcult_Greenskins_&_FactionCrookedMoon_Goblin_Great_Shaman_2_&_OtherFactionChaos_&_Positive	wh_main_sc_grn_greenskins
diplomacy_Subcult_Greenskins_&_FactionCrookedMoon_Goblin_Great_Shaman_2_&_OtherFactionDwarf	wh_main_sc_grn_greenskins
diplomacy_Subcult_Greenskins_&_FactionCrookedMoon_Goblin_Great_Shaman_2_&_OtherFactionDwarf_&_Negative	wh_main_sc_grn_greenskins
diplomacy_Subcult_Greenskins_&_FactionCrookedMoon_Goblin_Great_Shaman_2_&_OtherFactionDwarf_&_Positive	wh_main_sc_grn_greenskins
diplomacy_Subcult_Greenskins_&_FactionCrookedMoon_Goblin_Great_Shaman_2_&_OtherFactionEmpire	wh_main_sc_grn_greenskins
diplomacy_Subcult_Greenskins_&_FactionCrookedMoon_Goblin_Great_Shaman_2_&_OtherFactionEmpire_&_Negative	wh_main_sc_grn_greenskins
diplomacy_Subcult_Greenskins_&_FactionCrookedMoon_Goblin_Great_Shaman_2_&_OtherFactionEmpire_&_Positive	wh_main_sc_grn_greenskins
diplomacy_Subcult_Greenskins_&_FactionCrookedMoon_Goblin_Great_Shaman_2_&_OtherFactionGreenskin	wh_main_sc_grn_greenskins
diplomacy_Subcult_Greenskins_&_FactionCrookedMoon_Goblin_Great_Shaman_2_&_OtherFactionGreenskin_&_Negative	wh_main_sc_grn_greenskins
diplomacy_Subcult_Greenskins_&_FactionCrookedMoon_Goblin_Great_Shaman_2_&_OtherFactionGreenskin_&_Positive	wh_main_sc_grn_greenskins
diplomacy_Subcult_Greenskins_&_FactionCrookedMoon_Goblin_Great_Shaman_2_&_OtherFactionVamp	wh_main_sc_grn_greenskins
diplomacy_Subcult_Greenskins_&_FactionCrookedMoon_Goblin_Great_Shaman_2_&_OtherFactionVamp_&_Negative	wh_main_sc_grn_greenskins
diplomacy_Subcult_Greenskins_&_FactionCrookedMoon_Goblin_Great_Shaman_2_&_OtherFactionVamp_&_Positive	wh_main_sc_grn_greenskins
diplomacy_Subcult_Greenskins_&_FactionCrookedMoon_Goblin_Great_Shaman_2_&_Positive	wh_main_sc_grn_greenskins
diplomacy_Subcult_Greenskins_&_FactionRedEye_Goblin_Great_Shaman_1	wh_main_sc_grn_greenskins
diplomacy_Subcult_Greenskins_&_FactionRedEye_Goblin_Great_Shaman_1_&_Negative	wh_main_sc_grn_greenskins
diplomacy_Subcult_Greenskins_&_FactionRedEye_Goblin_Great_Shaman_1_&_OtherFactionBretonnia	wh_main_sc_grn_greenskins
diplomacy_Subcult_Greenskins_&_FactionRedEye_Goblin_Great_Shaman_1_&_OtherFactionBretonnia_&_Negative	wh_main_sc_grn_greenskins
diplomacy_Subcult_Greenskins_&_FactionRedEye_Goblin_Great_Shaman_1_&_OtherFactionBretonnia_&_Positive	wh_main_sc_grn_greenskins
diplomacy_Subcult_Greenskins_&_FactionRedEye_Goblin_Great_Shaman_1_&_OtherFactionChaos	wh_main_sc_grn_greenskins
diplomacy_Subcult_Greenskins_&_FactionRedEye_Goblin_Great_Shaman_1_&_OtherFactionChaos_&_Negative	wh_main_sc_grn_greenskins
diplomacy_Subcult_Greenskins_&_FactionRedEye_Goblin_Great_Shaman_1_&_OtherFactionChaos_&_Positive	wh_main_sc_grn_greenskins
diplomacy_Subcult_Greenskins_&_FactionRedEye_Goblin_Great_Shaman_1_&_OtherFactionDwarf	wh_main_sc_grn_greenskins
diplomacy_Subcult_Greenskins_&_FactionRedEye_Goblin_Great_Shaman_1_&_OtherFactionDwarf_&_Negative	wh_main_sc_grn_greenskins
diplomacy_Subcult_Greenskins_&_FactionRedEye_Goblin_Great_Shaman_1_&_OtherFactionDwarf_&_Positive	wh_main_sc_grn_greenskins
diplomacy_Subcult_Greenskins_&_FactionRedEye_Goblin_Great_Shaman_1_&_OtherFactionEmpire	wh_main_sc_grn_greenskins
diplomacy_Subcult_Greenskins_&_FactionRedEye_Goblin_Great_Shaman_1_&_OtherFactionEmpire_&_Negative	wh_main_sc_grn_greenskins
diplomacy_Subcult_Greenskins_&_FactionRedEye_Goblin_Great_Shaman_1_&_OtherFactionEmpire_&_Positive	wh_main_sc_grn_greenskins
diplomacy_Subcult_Greenskins_&_FactionRedEye_Goblin_Great_Shaman_1_&_OtherFactionGreenskin	wh_main_sc_grn_greenskins
diplomacy_Subcult_Greenskins_&_FactionRedEye_Goblin_Great_Shaman_1_&_OtherFactionGreenskin_&_Negative	wh_main_sc_grn_greenskins
diplomacy_Subcult_Greenskins_&_FactionRedEye_Goblin_Great_Shaman_1_&_OtherFactionGreenskin_&_Positive	wh_main_sc_grn_greenskins
diplomacy_Subcult_Greenskins_&_FactionRedEye_Goblin_Great_Shaman_1_&_OtherFactionVamp	wh_main_sc_grn_greenskins
diplomacy_Subcult_Greenskins_&_FactionRedEye_Goblin_Great_Shaman_1_&_OtherFactionVamp_&_Negative	wh_main_sc_grn_greenskins
diplomacy_Subcult_Greenskins_&_FactionRedEye_Goblin_Great_Shaman_1_&_OtherFactionVamp_&_Positive	wh_main_sc_grn_greenskins
diplomacy_Subcult_Greenskins_&_FactionRedEye_Goblin_Great_Shaman_1_&_Positive	wh_main_sc_grn_greenskins
diplomacy_Subcult_Greenskins_&_FactionRedFangs_Orc_Warboss_2	wh_main_sc_grn_greenskins
diplomacy_Subcult_Greenskins_&_FactionRedFangs_Orc_Warboss_2_&_Negative	wh_main_sc_grn_greenskins
diplomacy_Subcult_Greenskins_&_FactionRedFangs_Orc_Warboss_2_&_OtherFactionBretonnia	wh_main_sc_grn_greenskins
diplomacy_Subcult_Greenskins_&_FactionRedFangs_Orc_Warboss_2_&_OtherFactionBretonnia_&_Positive	wh_main_sc_grn_greenskins
diplomacy_Subcult_Greenskins_&_FactionRedFangs_Orc_Warboss_2_&_OtherFactionChaos	wh_main_sc_grn_greenskins
diplomacy_Subcult_Greenskins_&_FactionRedFangs_Orc_Warboss_2_&_OtherFactionChaos_&_Negative	wh_main_sc_grn_greenskins
diplomacy_Subcult_Greenskins_&_FactionRedFangs_Orc_Warboss_2_&_OtherFactionChaos_&_Positive	wh_main_sc_grn_greenskins
diplomacy_Subcult_Greenskins_&_FactionRedFangs_Orc_Warboss_2_&_OtherFactionDwarf	wh_main_sc_grn_greenskins
diplomacy_Subcult_Greenskins_&_FactionRedFangs_Orc_Warboss_2_&_OtherFactionDwarf_&_Negative	wh_main_sc_grn_greenskins
diplomacy_Subcult_Greenskins_&_FactionRedFangs_Orc_Warboss_2_&_OtherFactionDwarf_&_Positive	wh_main_sc_grn_greenskins
diplomacy_Subcult_Greenskins_&_FactionRedFangs_Orc_Warboss_2_&_OtherFactionEmpire	wh_main_sc_grn_greenskins
diplomacy_Subcult_Greenskins_&_FactionRedFangs_Orc_Warboss_2_&_OtherFactionEmpire_&_Negative	wh_main_sc_grn_greenskins
diplomacy_Subcult_Greenskins_&_FactionRedFangs_Orc_Warboss_2_&_OtherFactionEmpire_&_Positive	wh_main_sc_grn_greenskins
diplomacy_Subcult_Greenskins_&_FactionRedFangs_Orc_Warboss_2_&_OtherFactionGreenskin	wh_main_sc_grn_greenskins
diplomacy_Subcult_Greenskins_&_FactionRedFangs_Orc_Warboss_2_&_OtherFactionGreenskin_&_Negative	wh_main_sc_grn_greenskins
diplomacy_Subcult_Greenskins_&_FactionRedFangs_Orc_Warboss_2_&_OtherFactionGreenskin_&_Positive	wh_main_sc_grn_greenskins
diplomacy_Subcult_Greenskins_&_FactionRedFangs_Orc_Warboss_2_&_OtherFactionVamp	wh_main_sc_grn_greenskins
diplomacy_Subcult_Greenskins_&_FactionRedFangs_Orc_Warboss_2_&_OtherFactionVamp_&_Negative	wh_main_sc_grn_greenskins
diplomacy_Subcult_Greenskins_&_FactionRedFangs_Orc_Warboss_2_&_OtherFactionVamp_&_Positive	wh_main_sc_grn_greenskins
diplomacy_Subcult_Greenskins_&_FactionRedFangs_Orc_Warboss_2_&_Positive	wh_main_sc_grn_greenskins
diplomacy_Subcult_Greenskins_&_FactionScabbyEye_Goblin_Great_Shaman_2	wh_main_sc_grn_greenskins
diplomacy_Subcult_Greenskins_&_FactionScabbyEye_Goblin_Great_Shaman_2_&_Negative	wh_main_sc_grn_greenskins
diplomacy_Subcult_Greenskins_&_FactionScabbyEye_Goblin_Great_Shaman_2_&_OtherFactionBretonnia	wh_main_sc_grn_greenskins
diplomacy_Subcult_Greenskins_&_FactionScabbyEye_Goblin_Great_Shaman_2_&_OtherFactionBretonnia_&_Negative	wh_main_sc_grn_greenskins
diplomacy_Subcult_Greenskins_&_FactionScabbyEye_Goblin_Great_Shaman_2_&_OtherFactionBretonnia_&_Positive	wh_main_sc_grn_greenskins
diplomacy_Subcult_Greenskins_&_FactionScabbyEye_Goblin_Great_Shaman_2_&_OtherFactionChaos	wh_main_sc_grn_greenskins
diplomacy_Subcult_Greenskins_&_FactionScabbyEye_Goblin_Great_Shaman_2_&_OtherFactionChaos_&_Negative	wh_main_sc_grn_greenskins
diplomacy_Subcult_Greenskins_&_FactionScabbyEye_Goblin_Great_Shaman_2_&_OtherFactionChaos_&_Positive	wh_main_sc_grn_greenskins
diplomacy_Subcult_Greenskins_&_FactionScabbyEye_Goblin_Great_Shaman_2_&_OtherFactionDwarf	wh_main_sc_grn_greenskins
diplomacy_Subcult_Greenskins_&_FactionScabbyEye_Goblin_Great_Shaman_2_&_OtherFactionDwarf_&_Negative	wh_main_sc_grn_greenskins
diplomacy_Subcult_Greenskins_&_FactionScabbyEye_Goblin_Great_Shaman_2_&_OtherFactionDwarf_&_Positive	wh_main_sc_grn_greenskins
diplomacy_Subcult_Greenskins_&_FactionScabbyEye_Goblin_Great_Shaman_2_&_OtherFactionEmpire	wh_main_sc_grn_greenskins
diplomacy_Subcult_Greenskins_&_FactionScabbyEye_Goblin_Great_Shaman_2_&_OtherFactionEmpire_&_Negative	wh_main_sc_grn_greenskins
diplomacy_Subcult_Greenskins_&_FactionScabbyEye_Goblin_Great_Shaman_2_&_OtherFactionEmpire_&_Positive	wh_main_sc_grn_greenskins
diplomacy_Subcult_Greenskins_&_FactionScabbyEye_Goblin_Great_Shaman_2_&_OtherFactionGreenskin	wh_main_sc_grn_greenskins
diplomacy_Subcult_Greenskins_&_FactionScabbyEye_Goblin_Great_Shaman_2_&_OtherFactionGreenskin_&_Negative	wh_main_sc_grn_greenskins
diplomacy_Subcult_Greenskins_&_FactionScabbyEye_Goblin_Great_Shaman_2_&_OtherFactionGreenskin_&_Positive	wh_main_sc_grn_greenskins
diplomacy_Subcult_Greenskins_&_FactionScabbyEye_Goblin_Great_Shaman_2_&_OtherFactionVamp	wh_main_sc_grn_greenskins
diplomacy_Subcult_Greenskins_&_FactionScabbyEye_Goblin_Great_Shaman_2_&_OtherFactionVamp_&_Negative	wh_main_sc_grn_greenskins
diplomacy_Subcult_Greenskins_&_FactionScabbyEye_Goblin_Great_Shaman_2_&_OtherFactionVamp_&_Positive	wh_main_sc_grn_greenskins
diplomacy_Subcult_Greenskins_&_FactionScabbyEye_Goblin_Great_Shaman_2_&_Positive	wh_main_sc_grn_greenskins
diplomacy_Subcult_Greenskins_&_FactionSkullsmasherz_Orc_Warboss_2	wh_main_sc_grn_greenskins
diplomacy_Subcult_Greenskins_&_FactionSkullsmasherz_Orc_Warboss_2_&_Negative	wh_main_sc_grn_greenskins
diplomacy_Subcult_Greenskins_&_FactionSkullsmasherz_Orc_Warboss_2_&_OtherFactionBretonnia	wh_main_sc_grn_greenskins
diplomacy_Subcult_Greenskins_&_FactionSkullsmasherz_Orc_Warboss_2_&_OtherFactionBretonnia_&_Negative	wh_main_sc_grn_greenskins
diplomacy_Subcult_Greenskins_&_FactionSkullsmasherz_Orc_Warboss_2_&_OtherFactionBretonnia_&_Positive	wh_main_sc_grn_greenskins
diplomacy_Subcult_Greenskins_&_FactionSkullsmasherz_Orc_Warboss_2_&_OtherFactionChaos	wh_main_sc_grn_greenskins
diplomacy_Subcult_Greenskins_&_FactionSkullsmasherz_Orc_Warboss_2_&_OtherFactionChaos_&_Negative	wh_main_sc_grn_greenskins
diplomacy_Subcult_Greenskins_&_FactionSkullsmasherz_Orc_Warboss_2_&_OtherFactionChaos_&_Positive	wh_main_sc_grn_greenskins
diplomacy_Subcult_Greenskins_&_FactionSkullsmasherz_Orc_Warboss_2_&_OtherFactionDwarf	wh_main_sc_grn_greenskins
diplomacy_Subcult_Greenskins_&_FactionSkullsmasherz_Orc_Warboss_2_&_OtherFactionDwarf_&_Negative	wh_main_sc_grn_greenskins
diplomacy_Subcult_Greenskins_&_FactionSkullsmasherz_Orc_Warboss_2_&_OtherFactionDwarf_&_Positive	wh_main_sc_grn_greenskins
diplomacy_Subcult_Greenskins_&_FactionSkullsmasherz_Orc_Warboss_2_&_OtherFactionEmpire	wh_main_sc_grn_greenskins
diplomacy_Subcult_Greenskins_&_FactionSkullsmasherz_Orc_Warboss_2_&_OtherFactionEmpire_&_Negative	wh_main_sc_grn_greenskins
diplomacy_Subcult_Greenskins_&_FactionSkullsmasherz_Orc_Warboss_2_&_OtherFactionEmpire_&_Positive	wh_main_sc_grn_greenskins
diplomacy_Subcult_Greenskins_&_FactionSkullsmasherz_Orc_Warboss_2_&_OtherFactionGreenskin	wh_main_sc_grn_greenskins
diplomacy_Subcult_Greenskins_&_FactionSkullsmasherz_Orc_Warboss_2_&_OtherFactionGreenskin_&_Negative	wh_main_sc_grn_greenskins
diplomacy_Subcult_Greenskins_&_FactionSkullsmasherz_Orc_Warboss_2_&_OtherFactionGreenskin_&_Positive	wh_main_sc_grn_greenskins
diplomacy_Subcult_Greenskins_&_FactionSkullsmasherz_Orc_Warboss_2_&_OtherFactionVamp	wh_main_sc_grn_greenskins
diplomacy_Subcult_Greenskins_&_FactionSkullsmasherz_Orc_Warboss_2_&_OtherFactionVamp_&_Negative	wh_main_sc_grn_greenskins
diplomacy_Subcult_Greenskins_&_FactionSkullsmasherz_Orc_Warboss_2_&_OtherFactionVamp_&_Positive	wh_main_sc_grn_greenskins
diplomacy_Subcult_Greenskins_&_FactionSkullsmasherz_Orc_Warboss_2_&_Positive	wh_main_sc_grn_greenskins
diplomacy_Subcult_Greenskins_&_FactionTeefSnatchaz_Goblin_Great_Shaman_1	wh_main_sc_grn_greenskins
diplomacy_Subcult_Greenskins_&_FactionTeefSnatchaz_Goblin_Great_Shaman_1_&_Negative	wh_main_sc_grn_greenskins
diplomacy_Subcult_Greenskins_&_FactionTeefSnatchaz_Goblin_Great_Shaman_1_&_OtherFactionBretonnia	wh_main_sc_grn_greenskins
diplomacy_Subcult_Greenskins_&_FactionTeefSnatchaz_Goblin_Great_Shaman_1_&_OtherFactionBretonnia_&_Negative	wh_main_sc_grn_greenskins
diplomacy_Subcult_Greenskins_&_FactionTeefSnatchaz_Goblin_Great_Shaman_1_&_OtherFactionBretonnia_&_Positive	wh_main_sc_grn_greenskins
diplomacy_Subcult_Greenskins_&_FactionTeefSnatchaz_Goblin_Great_Shaman_1_&_OtherFactionChaos	wh_main_sc_grn_greenskins
diplomacy_Subcult_Greenskins_&_FactionTeefSnatchaz_Goblin_Great_Shaman_1_&_OtherFactionChaos_&_Negative	wh_main_sc_grn_greenskins
diplomacy_Subcult_Greenskins_&_FactionTeefSnatchaz_Goblin_Great_Shaman_1_&_OtherFactionChaos_&_Positive	wh_main_sc_grn_greenskins
diplomacy_Subcult_Greenskins_&_FactionTeefSnatchaz_Goblin_Great_Shaman_1_&_OtherFactionDwarf	wh_main_sc_grn_greenskins
diplomacy_Subcult_Greenskins_&_FactionTeefSnatchaz_Goblin_Great_Shaman_1_&_OtherFactionDwarf_&_Negative	wh_main_sc_grn_greenskins
diplomacy_Subcult_Greenskins_&_FactionTeefSnatchaz_Goblin_Great_Shaman_1_&_OtherFactionDwarf_&_Positive	wh_main_sc_grn_greenskins
diplomacy_Subcult_Greenskins_&_FactionTeefSnatchaz_Goblin_Great_Shaman_1_&_OtherFactionEmpire	wh_main_sc_grn_greenskins
diplomacy_Subcult_Greenskins_&_FactionTeefSnatchaz_Goblin_Great_Shaman_1_&_OtherFactionEmpire_&_Negative	wh_main_sc_grn_greenskins
diplomacy_Subcult_Greenskins_&_FactionTeefSnatchaz_Goblin_Great_Shaman_1_&_OtherFactionEmpire_&_Positive	wh_main_sc_grn_greenskins
diplomacy_Subcult_Greenskins_&_FactionTeefSnatchaz_Goblin_Great_Shaman_1_&_OtherFactionGreenskin	wh_main_sc_grn_greenskins
diplomacy_Subcult_Greenskins_&_FactionTeefSnatchaz_Goblin_Great_Shaman_1_&_OtherFactionGreenskin_&_Negative	wh_main_sc_grn_greenskins
diplomacy_Subcult_Greenskins_&_FactionTeefSnatchaz_Goblin_Great_Shaman_1_&_OtherFactionGreenskin_&_Positive	wh_main_sc_grn_greenskins
diplomacy_Subcult_Greenskins_&_FactionTeefSnatchaz_Goblin_Great_Shaman_1_&_OtherFactionVamp	wh_main_sc_grn_greenskins
diplomacy_Subcult_Greenskins_&_FactionTeefSnatchaz_Goblin_Great_Shaman_1_&_OtherFactionVamp_&_Negative	wh_main_sc_grn_greenskins
diplomacy_Subcult_Greenskins_&_FactionTeefSnatchaz_Goblin_Great_Shaman_1_&_OtherFactionVamp_&_Positive	wh_main_sc_grn_greenskins
diplomacy_Subcult_Greenskins_&_FactionTeefSnatchaz_Goblin_Great_Shaman_1_&_Positive	wh_main_sc_grn_greenskins
diplomacy_Subcult_Greenskins_&_FactionTopKnotz_Orc_Warboss_2_&_OtherFactionBretonnia_&_Negative	wh_main_sc_grn_greenskins
diplomacy_Subcult_Greenskins_&_Negative	wh_main_sc_grn_greenskins
diplomacy_Subcult_Greenskins_&_OtherFactionBretonnia	wh_main_sc_grn_greenskins
diplomacy_Subcult_Greenskins_&_OtherFactionBretonnia_&_Negative	wh_main_sc_grn_greenskins
diplomacy_Subcult_Greenskins_&_OtherFactionBretonnia_&_Positive	wh_main_sc_grn_greenskins
diplomacy_Subcult_Greenskins_&_OtherFactionChaos	wh_main_sc_grn_greenskins
diplomacy_Subcult_Greenskins_&_OtherFactionChaos_&_Negative	wh_main_sc_grn_greenskins
diplomacy_Subcult_Greenskins_&_OtherFactionChaos_&_Positive	wh_main_sc_grn_greenskins
diplomacy_Subcult_Greenskins_&_OtherFactionDwarf	wh_main_sc_grn_greenskins
diplomacy_Subcult_Greenskins_&_OtherFactionDwarf_&_Negative	wh_main_sc_grn_greenskins
diplomacy_Subcult_Greenskins_&_OtherFactionDwarf_&_Positive	wh_main_sc_grn_greenskins
diplomacy_Subcult_Greenskins_&_OtherFactionEmpire	wh_main_sc_grn_greenskins
diplomacy_Subcult_Greenskins_&_OtherFactionEmpire_&_Negative	wh_main_sc_grn_greenskins
diplomacy_Subcult_Greenskins_&_OtherFactionEmpire_&_Positive	wh_main_sc_grn_greenskins
diplomacy_Subcult_Greenskins_&_OtherFactionGreenskin	wh_main_sc_grn_greenskins
diplomacy_Subcult_Greenskins_&_OtherFactionGreenskin_&_Negative	wh_main_sc_grn_greenskins
diplomacy_Subcult_Greenskins_&_OtherFactionGreenskin_&_Positive	wh_main_sc_grn_greenskins
diplomacy_Subcult_Greenskins_&_OtherFactionVamp	wh_main_sc_grn_greenskins
diplomacy_Subcult_Greenskins_&_OtherFactionVamp_&_Negative	wh_main_sc_grn_greenskins
diplomacy_Subcult_Greenskins_&_OtherFactionVamp_&_Positive	wh_main_sc_grn_greenskins
diplomacy_Subcult_Greenskins_&_Positive	wh_main_sc_grn_greenskins
diplomacy_Subcult_HighElves	wh2_main_sc_hef_high_elves
diplomacy_Subcult_HighElves_&_Negative	wh2_main_sc_hef_high_elves
diplomacy_Subcult_HighElves_&_OtherFactionBeastmen	wh2_main_sc_hef_high_elves
diplomacy_Subcult_HighElves_&_OtherFactionBeastmen_&_Negative	wh2_main_sc_hef_high_elves
diplomacy_Subcult_HighElves_&_OtherFactionBeastmen_&_Positive	wh2_main_sc_hef_high_elves
diplomacy_Subcult_HighElves_&_OtherFactionBretonnia	wh2_main_sc_hef_high_elves
diplomacy_Subcult_HighElves_&_OtherFactionBretonnia_&_Negative	wh2_main_sc_hef_high_elves
diplomacy_Subcult_HighElves_&_OtherFactionBretonnia_&_Positive	wh2_main_sc_hef_high_elves
diplomacy_Subcult_HighElves_&_OtherFactionChaos	wh2_main_sc_hef_high_elves
diplomacy_Subcult_HighElves_&_OtherFactionChaos_&_Negative	wh2_main_sc_hef_high_elves
diplomacy_Subcult_HighElves_&_OtherFactionChaos_&_Positive	wh2_main_sc_hef_high_elves
diplomacy_Subcult_HighElves_&_OtherFactionDarkElves	wh2_main_sc_hef_high_elves
diplomacy_Subcult_HighElves_&_OtherFactionDarkElves_&_Negative	wh2_main_sc_hef_high_elves
diplomacy_Subcult_HighElves_&_OtherFactionDarkElves_&_Positive	wh2_main_sc_hef_high_elves
diplomacy_Subcult_HighElves_&_OtherFactionDwarf	wh2_main_sc_hef_high_elves
diplomacy_Subcult_HighElves_&_OtherFactionDwarf_&_Negative	wh2_main_sc_hef_high_elves
diplomacy_Subcult_HighElves_&_OtherFactionDwarf_&_Positive	wh2_main_sc_hef_high_elves
diplomacy_Subcult_HighElves_&_OtherFactionEmpire	wh2_main_sc_hef_high_elves
diplomacy_Subcult_HighElves_&_OtherFactionEmpire_&_Negative	wh2_main_sc_hef_high_elves
diplomacy_Subcult_HighElves_&_OtherFactionEmpire_&_Positive	wh2_main_sc_hef_high_elves
diplomacy_Subcult_HighElves_&_OtherFactionGreenskin	wh2_main_sc_hef_high_elves
diplomacy_Subcult_HighElves_&_OtherFactionGreenskin_&_Negative	wh2_main_sc_hef_high_elves
diplomacy_Subcult_HighElves_&_OtherFactionGreenskin_&_Positive	wh2_main_sc_hef_high_elves
diplomacy_Subcult_HighElves_&_OtherFactionHighElves	wh2_main_sc_hef_high_elves
diplomacy_Subcult_HighElves_&_OtherFactionHighElves_&_Negative	wh2_main_sc_hef_high_elves
diplomacy_Subcult_HighElves_&_OtherFactionHighElves_&_Positive	wh2_main_sc_hef_high_elves
diplomacy_Subcult_HighElves_&_OtherFactionLizardmen	wh2_main_sc_hef_high_elves
diplomacy_Subcult_HighElves_&_OtherFactionLizardmen_&_Negative	wh2_main_sc_hef_high_elves
diplomacy_Subcult_HighElves_&_OtherFactionLizardmen_&_Positive	wh2_main_sc_hef_high_elves
diplomacy_Subcult_HighElves_&_OtherFactionSkaven	wh2_main_sc_hef_high_elves
diplomacy_Subcult_HighElves_&_OtherFactionSkaven_&_Negative	wh2_main_sc_hef_high_elves
diplomacy_Subcult_HighElves_&_OtherFactionSkaven_&_Positive	wh2_main_sc_hef_high_elves
diplomacy_Subcult_HighElves_&_OtherFactionVamp	wh2_main_sc_hef_high_elves
diplomacy_Subcult_HighElves_&_OtherFactionVamp_&_Negative	wh2_main_sc_hef_high_elves
diplomacy_Subcult_HighElves_&_OtherFactionVamp_&_Positive	wh2_main_sc_hef_high_elves
diplomacy_Subcult_HighElves_&_OtherFactionWoodElves	wh2_main_sc_hef_high_elves
diplomacy_Subcult_HighElves_&_OtherFactionWoodElves_&_Negative	wh2_main_sc_hef_high_elves
diplomacy_Subcult_HighElves_&_OtherFactionWoodElves_&_Positive	wh2_main_sc_hef_high_elves
diplomacy_Subcult_HighElves_&_Positive	wh2_main_sc_hef_high_elves
diplomacy_Subcult_Kislev	wh_main_sc_ksl_kislev
diplomacy_Subcult_Kislev_&_Negative	wh_main_sc_ksl_kislev
diplomacy_Subcult_Kislev_&_OtherFactionBretonnia	wh_main_sc_ksl_kislev
diplomacy_Subcult_Kislev_&_OtherFactionBretonnia_&_Negative	wh_main_sc_ksl_kislev
diplomacy_Subcult_Kislev_&_OtherFactionBretonnia_&_Positive	wh_main_sc_ksl_kislev
diplomacy_Subcult_Kislev_&_OtherFactionChaos	wh_main_sc_ksl_kislev
diplomacy_Subcult_Kislev_&_OtherFactionChaos_&_Negative	wh_main_sc_ksl_kislev
diplomacy_Subcult_Kislev_&_OtherFactionChaos_&_Positive	wh_main_sc_ksl_kislev
diplomacy_Subcult_Kislev_&_OtherFactionDwarf	wh_main_sc_ksl_kislev
diplomacy_Subcult_Kislev_&_OtherFactionDwarf_&_Negative	wh_main_sc_ksl_kislev
diplomacy_Subcult_Kislev_&_OtherFactionDwarf_&_Positive	wh_main_sc_ksl_kislev
diplomacy_Subcult_Kislev_&_OtherFactionEmpire	wh_main_sc_ksl_kislev
diplomacy_Subcult_Kislev_&_OtherFactionEmpire_&_Negative	wh_main_sc_ksl_kislev
diplomacy_Subcult_Kislev_&_OtherFactionEmpire_&_Positive	wh_main_sc_ksl_kislev
diplomacy_Subcult_Kislev_&_OtherFactionGreenskin	wh_main_sc_ksl_kislev
diplomacy_Subcult_Kislev_&_OtherFactionGreenskin_&_Negative	wh_main_sc_ksl_kislev
diplomacy_Subcult_Kislev_&_OtherFactionGreenskin_&_Positive	wh_main_sc_ksl_kislev
diplomacy_Subcult_Kislev_&_OtherFactionVamp	wh_main_sc_ksl_kislev
diplomacy_Subcult_Kislev_&_OtherFactionVamp_&_Negative	wh_main_sc_ksl_kislev
diplomacy_Subcult_Kislev_&_OtherFactionVamp_&_Positive	wh_main_sc_ksl_kislev
diplomacy_Subcult_Kislev_&_Positive	wh_main_sc_ksl_kislev
diplomacy_Subcult_Lizardmen	wh2_main_sc_lzd_lizardmen
diplomacy_Subcult_Lizardmen_&_Negative	wh2_main_sc_lzd_lizardmen
diplomacy_Subcult_Lizardmen_&_OtherFactionBeastmen	wh2_main_sc_lzd_lizardmen
diplomacy_Subcult_Lizardmen_&_OtherFactionBeastmen_&_Negative	wh2_main_sc_lzd_lizardmen
diplomacy_Subcult_Lizardmen_&_OtherFactionBeastmen_&_Positive	wh2_main_sc_lzd_lizardmen
diplomacy_Subcult_Lizardmen_&_OtherFactionBretonnia	wh2_main_sc_lzd_lizardmen
diplomacy_Subcult_Lizardmen_&_OtherFactionBretonnia_&_Negative	wh2_main_sc_lzd_lizardmen
diplomacy_Subcult_Lizardmen_&_OtherFactionBretonnia_&_Positive	wh2_main_sc_lzd_lizardmen
diplomacy_Subcult_Lizardmen_&_OtherFactionChaos	wh2_main_sc_lzd_lizardmen
diplomacy_Subcult_Lizardmen_&_OtherFactionChaos_&_Negative	wh2_main_sc_lzd_lizardmen
diplomacy_Subcult_Lizardmen_&_OtherFactionChaos_&_Positive	wh2_main_sc_lzd_lizardmen
diplomacy_Subcult_Lizardmen_&_OtherFactionDarkElves	wh2_main_sc_lzd_lizardmen
diplomacy_Subcult_Lizardmen_&_OtherFactionDarkElves_&_Negative	wh2_main_sc_lzd_lizardmen
diplomacy_Subcult_Lizardmen_&_OtherFactionDarkElves_&_Positive	wh2_main_sc_lzd_lizardmen
diplomacy_Subcult_Lizardmen_&_OtherFactionDwarf	wh2_main_sc_lzd_lizardmen
diplomacy_Subcult_Lizardmen_&_OtherFactionDwarf_&_Negative	wh2_main_sc_lzd_lizardmen
diplomacy_Subcult_Lizardmen_&_OtherFactionDwarf_&_Positive	wh2_main_sc_lzd_lizardmen
diplomacy_Subcult_Lizardmen_&_OtherFactionEmpire	wh2_main_sc_lzd_lizardmen
diplomacy_Subcult_Lizardmen_&_OtherFactionEmpire_&_Negative	wh2_main_sc_lzd_lizardmen
diplomacy_Subcult_Lizardmen_&_OtherFactionEmpire_&_Positive	wh2_main_sc_lzd_lizardmen
diplomacy_Subcult_Lizardmen_&_OtherFactionGreenskin	wh2_main_sc_lzd_lizardmen
diplomacy_Subcult_Lizardmen_&_OtherFactionGreenskin_&_Negative	wh2_main_sc_lzd_lizardmen
diplomacy_Subcult_Lizardmen_&_OtherFactionGreenskin_&_Positive	wh2_main_sc_lzd_lizardmen
diplomacy_Subcult_Lizardmen_&_OtherFactionHighElves	wh2_main_sc_lzd_lizardmen
diplomacy_Subcult_Lizardmen_&_OtherFactionHighElves_&_Negative	wh2_main_sc_lzd_lizardmen
diplomacy_Subcult_Lizardmen_&_OtherFactionHighElves_&_Positive	wh2_main_sc_lzd_lizardmen
diplomacy_Subcult_Lizardmen_&_OtherFactionLizardmen	wh2_main_sc_lzd_lizardmen
diplomacy_Subcult_Lizardmen_&_OtherFactionLizardmen_&_Negative	wh2_main_sc_lzd_lizardmen
diplomacy_Subcult_Lizardmen_&_OtherFactionLizardmen_&_Positive	wh2_main_sc_lzd_lizardmen
diplomacy_Subcult_Lizardmen_&_OtherFactionSkaven	wh2_main_sc_lzd_lizardmen
diplomacy_Subcult_Lizardmen_&_OtherFactionSkaven_&_Negative	wh2_main_sc_lzd_lizardmen
diplomacy_Subcult_Lizardmen_&_OtherFactionSkaven_&_Positive	wh2_main_sc_lzd_lizardmen
diplomacy_Subcult_Lizardmen_&_OtherFactionVamp	wh2_main_sc_lzd_lizardmen
diplomacy_Subcult_Lizardmen_&_OtherFactionVamp_&_Negative	wh2_main_sc_lzd_lizardmen
diplomacy_Subcult_Lizardmen_&_OtherFactionVamp_&_Positive	wh2_main_sc_lzd_lizardmen
diplomacy_Subcult_Lizardmen_&_OtherFactionWoodElves	wh2_main_sc_lzd_lizardmen
diplomacy_Subcult_Lizardmen_&_OtherFactionWoodElves_&_Negative	wh2_main_sc_lzd_lizardmen
diplomacy_Subcult_Lizardmen_&_OtherFactionWoodElves_&_Positive	wh2_main_sc_lzd_lizardmen
diplomacy_Subcult_Lizardmen_&_Positive	wh2_main_sc_lzd_lizardmen
diplomacy_Subcult_Norsca	wh_main_sc_nor_norsca
diplomacy_Subcult_Norsca_&_FactionVarg_Norsca_Sorceror_Lord	wh_main_sc_nor_norsca
diplomacy_Subcult_Norsca_&_FactionVarg_Norsca_Sorceror_Lord_&_Negative	wh_main_sc_nor_norsca
diplomacy_Subcult_Norsca_&_FactionVarg_Norsca_Sorceror_Lord_&_Positive	wh_main_sc_nor_norsca
diplomacy_Subcult_Norsca_&_Negative	wh_main_sc_nor_norsca
diplomacy_Subcult_Norsca_&_OtherFactionBretonnia	wh_main_sc_nor_norsca
diplomacy_Subcult_Norsca_&_OtherFactionBretonnia_&_Negative	wh_main_sc_nor_norsca
diplomacy_Subcult_Norsca_&_OtherFactionBretonnia_&_Positive	wh_main_sc_nor_norsca
diplomacy_Subcult_Norsca_&_OtherFactionChaos	wh_main_sc_nor_norsca
diplomacy_Subcult_Norsca_&_OtherFactionChaos_&_Negative	wh_main_sc_nor_norsca
diplomacy_Subcult_Norsca_&_OtherFactionChaos_&_Positive	wh_main_sc_nor_norsca
diplomacy_Subcult_Norsca_&_OtherFactionDwarf	wh_main_sc_nor_norsca
diplomacy_Subcult_Norsca_&_OtherFactionDwarf_&_Negative	wh_main_sc_nor_norsca
diplomacy_Subcult_Norsca_&_OtherFactionDwarf_&_Positive	wh_main_sc_nor_norsca
diplomacy_Subcult_Norsca_&_OtherFactionEmpire	wh_main_sc_nor_norsca
diplomacy_Subcult_Norsca_&_OtherFactionEmpire_&_Negative	wh_main_sc_nor_norsca
diplomacy_Subcult_Norsca_&_OtherFactionEmpire_&_Positive	wh_main_sc_nor_norsca
diplomacy_Subcult_Norsca_&_OtherFactionGreenskin	wh_main_sc_nor_norsca
diplomacy_Subcult_Norsca_&_OtherFactionGreenskin_&_Negative	wh_main_sc_nor_norsca
diplomacy_Subcult_Norsca_&_OtherFactionGreenskin_&_Positive	wh_main_sc_nor_norsca
diplomacy_Subcult_Norsca_&_OtherFactionVamp	wh_main_sc_nor_norsca
diplomacy_Subcult_Norsca_&_OtherFactionVamp_&_Negative	wh_main_sc_nor_norsca
diplomacy_Subcult_Norsca_&_OtherFactionVamp_&_Positive	wh_main_sc_nor_norsca
diplomacy_Subcult_Norsca_&_Positive	wh_main_sc_nor_norsca
diplomacy_Subcult_SavageOrcs	wh_main_sc_grn_savage_orcs
diplomacy_Subcult_SavageOrcs_&_Negative	wh_main_sc_grn_savage_orcs
diplomacy_Subcult_SavageOrcs_&_OtherFactionBretonnia	wh_main_sc_grn_savage_orcs
diplomacy_Subcult_SavageOrcs_&_OtherFactionBretonnia_&_Negative	wh_main_sc_grn_savage_orcs
diplomacy_Subcult_SavageOrcs_&_OtherFactionBretonnia_&_Positive	wh_main_sc_grn_savage_orcs
diplomacy_Subcult_SavageOrcs_&_OtherFactionChaos	wh_main_sc_grn_savage_orcs
diplomacy_Subcult_SavageOrcs_&_OtherFactionChaos_&_Negative	wh_main_sc_grn_savage_orcs
diplomacy_Subcult_SavageOrcs_&_OtherFactionChaos_&_Positive	wh_main_sc_grn_savage_orcs
diplomacy_Subcult_SavageOrcs_&_OtherFactionDwarf	wh_main_sc_grn_savage_orcs
diplomacy_Subcult_SavageOrcs_&_OtherFactionDwarf_&_Negative	wh_main_sc_grn_savage_orcs
diplomacy_Subcult_SavageOrcs_&_OtherFactionDwarf_&_Positive	wh_main_sc_grn_savage_orcs
diplomacy_Subcult_SavageOrcs_&_OtherFactionEmpire	wh_main_sc_grn_savage_orcs
diplomacy_Subcult_SavageOrcs_&_OtherFactionEmpire_&_Negative	wh_main_sc_grn_savage_orcs
diplomacy_Subcult_SavageOrcs_&_OtherFactionEmpire_&_Positive	wh_main_sc_grn_savage_orcs
diplomacy_Subcult_SavageOrcs_&_OtherFactionGreenskin	wh_main_sc_grn_savage_orcs
diplomacy_Subcult_SavageOrcs_&_OtherFactionGreenskin_&_Negative	wh_main_sc_grn_savage_orcs
diplomacy_Subcult_SavageOrcs_&_OtherFactionGreenskin_&_Positive	wh_main_sc_grn_savage_orcs
diplomacy_Subcult_SavageOrcs_&_OtherFactionVamp	wh_main_sc_grn_savage_orcs
diplomacy_Subcult_SavageOrcs_&_OtherFactionVamp_&_Negative	wh_main_sc_grn_savage_orcs
diplomacy_Subcult_SavageOrcs_&_OtherFactionVamp_&_Positive	wh_main_sc_grn_savage_orcs
diplomacy_Subcult_SavageOrcs_&_Positive	wh_main_sc_grn_savage_orcs
diplomacy_Subcult_Skaven	wh2_main_sc_skv_skaven
diplomacy_Subcult_Skaven_&_Negative	wh2_main_sc_skv_skaven
diplomacy_Subcult_Skaven_&_OtherFactionBeastmen	wh2_main_sc_skv_skaven
diplomacy_Subcult_Skaven_&_OtherFactionBeastmen_&_Negative	wh2_main_sc_skv_skaven
diplomacy_Subcult_Skaven_&_OtherFactionBeastmen_&_Positive	wh2_main_sc_skv_skaven
diplomacy_Subcult_Skaven_&_OtherFactionBretonnia	wh2_main_sc_skv_skaven
diplomacy_Subcult_Skaven_&_OtherFactionBretonnia_&_Negative	wh2_main_sc_skv_skaven
diplomacy_Subcult_Skaven_&_OtherFactionBretonnia_&_Positive	wh2_main_sc_skv_skaven
diplomacy_Subcult_Skaven_&_OtherFactionChaos	wh2_main_sc_skv_skaven
diplomacy_Subcult_Skaven_&_OtherFactionChaos_&_Negative	wh2_main_sc_skv_skaven
diplomacy_Subcult_Skaven_&_OtherFactionChaos_&_Positive	wh2_main_sc_skv_skaven
diplomacy_Subcult_Skaven_&_OtherFactionDarkElves	wh2_main_sc_skv_skaven
diplomacy_Subcult_Skaven_&_OtherFactionDarkElves_&_Negative	wh2_main_sc_skv_skaven
diplomacy_Subcult_Skaven_&_OtherFactionDarkElves_&_Positive	wh2_main_sc_skv_skaven
diplomacy_Subcult_Skaven_&_OtherFactionDwarf	wh2_main_sc_skv_skaven
diplomacy_Subcult_Skaven_&_OtherFactionDwarf_&_Negative	wh2_main_sc_skv_skaven
diplomacy_Subcult_Skaven_&_OtherFactionDwarf_&_Positive	wh2_main_sc_skv_skaven
diplomacy_Subcult_Skaven_&_OtherFactionEmpire	wh2_main_sc_skv_skaven
diplomacy_Subcult_Skaven_&_OtherFactionEmpire_&_Negative	wh2_main_sc_skv_skaven
diplomacy_Subcult_Skaven_&_OtherFactionEmpire_&_Positive	wh2_main_sc_skv_skaven
diplomacy_Subcult_Skaven_&_OtherFactionGreenskin	wh2_main_sc_skv_skaven
diplomacy_Subcult_Skaven_&_OtherFactionGreenskin_&_Negative	wh2_main_sc_skv_skaven
diplomacy_Subcult_Skaven_&_OtherFactionGreenskin_&_Positive	wh2_main_sc_skv_skaven
diplomacy_Subcult_Skaven_&_OtherFactionHighElves	wh2_main_sc_skv_skaven
diplomacy_Subcult_Skaven_&_OtherFactionHighElves_&_Negative	wh2_main_sc_skv_skaven
diplomacy_Subcult_Skaven_&_OtherFactionHighElves_&_Positive	wh2_main_sc_skv_skaven
diplomacy_Subcult_Skaven_&_OtherFactionLizardmen	wh2_main_sc_skv_skaven
diplomacy_Subcult_Skaven_&_OtherFactionLizardmen_&_Negative	wh2_main_sc_skv_skaven
diplomacy_Subcult_Skaven_&_OtherFactionLizardmen_&_Positive	wh2_main_sc_skv_skaven
diplomacy_Subcult_Skaven_&_OtherFactionSkaven	wh2_main_sc_skv_skaven
diplomacy_Subcult_Skaven_&_OtherFactionSkaven_&_Negative	wh2_main_sc_skv_skaven
diplomacy_Subcult_Skaven_&_OtherFactionSkaven_&_Positive	wh2_main_sc_skv_skaven
diplomacy_Subcult_Skaven_&_OtherFactionVamp	wh2_main_sc_skv_skaven
diplomacy_Subcult_Skaven_&_OtherFactionVamp_&_Negative	wh2_main_sc_skv_skaven
diplomacy_Subcult_Skaven_&_OtherFactionVamp_&_Positive	wh2_main_sc_skv_skaven
diplomacy_Subcult_Skaven_&_OtherFactionWoodElves	wh2_main_sc_skv_skaven
diplomacy_Subcult_Skaven_&_OtherFactionWoodElves_&_Negative	wh2_main_sc_skv_skaven
diplomacy_Subcult_Skaven_&_OtherFactionWoodElves_&_Positive	wh2_main_sc_skv_skaven
diplomacy_Subcult_Skaven_&_Positive	wh2_main_sc_skv_skaven
diplomacy_Subcult_TEB	wh_main_sc_teb_teb
diplomacy_Subcult_TEB_&_Negative	wh_main_sc_teb_teb
diplomacy_Subcult_TEB_&_OtherFactionBretonnia	wh_main_sc_teb_teb
diplomacy_Subcult_TEB_&_OtherFactionBretonnia_&_Negative	wh_main_sc_teb_teb
diplomacy_Subcult_TEB_&_OtherFactionBretonnia_&_Positive	wh_main_sc_teb_teb
diplomacy_Subcult_TEB_&_OtherFactionChaos	wh_main_sc_teb_teb
diplomacy_Subcult_TEB_&_OtherFactionChaos_&_Negative	wh_main_sc_teb_teb
diplomacy_Subcult_TEB_&_OtherFactionChaos_&_Positive	wh_main_sc_teb_teb
diplomacy_Subcult_TEB_&_OtherFactionDwarf	wh_main_sc_teb_teb
diplomacy_Subcult_TEB_&_OtherFactionDwarf_&_Negative	wh_main_sc_teb_teb
diplomacy_Subcult_TEB_&_OtherFactionDwarf_&_Positive	wh_main_sc_teb_teb
diplomacy_Subcult_TEB_&_OtherFactionEmpire	wh_main_sc_teb_teb
diplomacy_Subcult_TEB_&_OtherFactionEmpire_&_Negative	wh_main_sc_teb_teb
diplomacy_Subcult_TEB_&_OtherFactionEmpire_&_Positive	wh_main_sc_teb_teb
diplomacy_Subcult_TEB_&_OtherFactionGreenskin	wh_main_sc_teb_teb
diplomacy_Subcult_TEB_&_OtherFactionGreenskin_&_Negative	wh_main_sc_teb_teb
diplomacy_Subcult_TEB_&_OtherFactionGreenskin_&_Positive	wh_main_sc_teb_teb
diplomacy_Subcult_TEB_&_OtherFactionVamp	wh_main_sc_teb_teb
diplomacy_Subcult_TEB_&_OtherFactionVamp_&_Negative	wh_main_sc_teb_teb
diplomacy_Subcult_TEB_&_OtherFactionVamp_&_Positive	wh_main_sc_teb_teb
diplomacy_Subcult_TEB_&_Positive	wh_main_sc_teb_teb
diplomacy_Subcult_Vampire	wh_main_sc_vmp_vampire_counts
diplomacy_Subcult_Vampire_&_FactionTemplehof_Master_Necromancer_Lord_1	wh_main_sc_vmp_vampire_counts
diplomacy_Subcult_Vampire_&_FactionTemplehof_Master_Necromancer_Lord_1_&_Negative	wh_main_sc_vmp_vampire_counts
diplomacy_Subcult_Vampire_&_FactionTemplehof_Master_Necromancer_Lord_1_&_OtherFactionBretonnia	wh_main_sc_vmp_vampire_counts
diplomacy_Subcult_Vampire_&_FactionTemplehof_Master_Necromancer_Lord_1_&_OtherFactionBretonnia_&_Negative	wh_main_sc_vmp_vampire_counts
diplomacy_Subcult_Vampire_&_FactionTemplehof_Master_Necromancer_Lord_1_&_OtherFactionBretonnia_&_Positive	wh_main_sc_vmp_vampire_counts
diplomacy_Subcult_Vampire_&_FactionTemplehof_Master_Necromancer_Lord_1_&_OtherFactionChaos	wh_main_sc_vmp_vampire_counts
diplomacy_Subcult_Vampire_&_FactionTemplehof_Master_Necromancer_Lord_1_&_OtherFactionChaos_&_Negative	wh_main_sc_vmp_vampire_counts
diplomacy_Subcult_Vampire_&_FactionTemplehof_Master_Necromancer_Lord_1_&_OtherFactionChaos_&_Positive	wh_main_sc_vmp_vampire_counts
diplomacy_Subcult_Vampire_&_FactionTemplehof_Master_Necromancer_Lord_1_&_OtherFactionDwarf	wh_main_sc_vmp_vampire_counts
diplomacy_Subcult_Vampire_&_FactionTemplehof_Master_Necromancer_Lord_1_&_OtherFactionDwarf_&_Negative	wh_main_sc_vmp_vampire_counts
diplomacy_Subcult_Vampire_&_FactionTemplehof_Master_Necromancer_Lord_1_&_OtherFactionDwarf_&_Positive	wh_main_sc_vmp_vampire_counts
diplomacy_Subcult_Vampire_&_FactionTemplehof_Master_Necromancer_Lord_1_&_OtherFactionEmpire	wh_main_sc_vmp_vampire_counts
diplomacy_Subcult_Vampire_&_FactionTemplehof_Master_Necromancer_Lord_1_&_OtherFactionEmpire_&_Negative	wh_main_sc_vmp_vampire_counts
diplomacy_Subcult_Vampire_&_FactionTemplehof_Master_Necromancer_Lord_1_&_OtherFactionEmpire_&_Positive	wh_main_sc_vmp_vampire_counts
diplomacy_Subcult_Vampire_&_FactionTemplehof_Master_Necromancer_Lord_1_&_OtherFactionGreenskin	wh_main_sc_vmp_vampire_counts
diplomacy_Subcult_Vampire_&_FactionTemplehof_Master_Necromancer_Lord_1_&_OtherFactionGreenskin_&_Negative	wh_main_sc_vmp_vampire_counts
diplomacy_Subcult_Vampire_&_FactionTemplehof_Master_Necromancer_Lord_1_&_OtherFactionGreenskin_&_Positive	wh_main_sc_vmp_vampire_counts
diplomacy_Subcult_Vampire_&_FactionTemplehof_Master_Necromancer_Lord_1_&_OtherFactionVamp	wh_main_sc_vmp_vampire_counts
diplomacy_Subcult_Vampire_&_FactionTemplehof_Master_Necromancer_Lord_1_&_OtherFactionVamp_&_Negative	wh_main_sc_vmp_vampire_counts
diplomacy_Subcult_Vampire_&_FactionTemplehof_Master_Necromancer_Lord_1_&_OtherFactionVamp_&_Positive	wh_main_sc_vmp_vampire_counts
diplomacy_Subcult_Vampire_&_FactionTemplehof_Master_Necromancer_Lord_1_&_Positive	wh_main_sc_vmp_vampire_counts
diplomacy_Subcult_Vampire_&_Negative	wh_main_sc_vmp_vampire_counts
diplomacy_Subcult_Vampire_&_OtherFactionBretonnia	wh_main_sc_vmp_vampire_counts
diplomacy_Subcult_Vampire_&_OtherFactionBretonnia_&_Negative	wh_main_sc_vmp_vampire_counts
diplomacy_Subcult_Vampire_&_OtherFactionBretonnia_&_Positive	wh_main_sc_vmp_vampire_counts
diplomacy_Subcult_Vampire_&_OtherFactionChaos	wh_main_sc_vmp_vampire_counts
diplomacy_Subcult_Vampire_&_OtherFactionChaos_&_Negative	wh_main_sc_vmp_vampire_counts
diplomacy_Subcult_Vampire_&_OtherFactionChaos_&_Positive	wh_main_sc_vmp_vampire_counts
diplomacy_Subcult_Vampire_&_OtherFactionDwarf	wh_main_sc_vmp_vampire_counts
diplomacy_Subcult_Vampire_&_OtherFactionDwarf_&_Negative	wh_main_sc_vmp_vampire_counts
diplomacy_Subcult_Vampire_&_OtherFactionDwarf_&_Positive	wh_main_sc_vmp_vampire_counts
diplomacy_Subcult_Vampire_&_OtherFactionEmpire	wh_main_sc_vmp_vampire_counts
diplomacy_Subcult_Vampire_&_OtherFactionEmpire_&_Negative	wh_main_sc_vmp_vampire_counts
diplomacy_Subcult_Vampire_&_OtherFactionEmpire_&_Positive	wh_main_sc_vmp_vampire_counts
diplomacy_Subcult_Vampire_&_OtherFactionGreenskin	wh_main_sc_vmp_vampire_counts
diplomacy_Subcult_Vampire_&_OtherFactionGreenskin_&_Negative	wh_main_sc_vmp_vampire_counts
diplomacy_Subcult_Vampire_&_OtherFactionGreenskin_&_Positive	wh_main_sc_vmp_vampire_counts
diplomacy_Subcult_Vampire_&_OtherFactionVamp	wh_main_sc_vmp_vampire_counts
diplomacy_Subcult_Vampire_&_OtherFactionVamp_&_Negative	wh_main_sc_vmp_vampire_counts
diplomacy_Subcult_Vampire_&_OtherFactionVamp_&_Positive	wh_main_sc_vmp_vampire_counts
diplomacy_Subcult_Vampire_&_Positive	wh_main_sc_vmp_vampire_counts
wh2_main_sc_chs_chaos_occupation_decision_liberate	wh_main_sc_nor_norsca
wh_dlc03_diplomacy_Subcult_Beastmen	wh_dlc03_sc_bst_beastmen
wh_dlc03_diplomacy_Subcult_Beastmen_&_FactionSecondary_Beastmen_Lord_2	wh_dlc03_sc_bst_beastmen
wh_dlc03_diplomacy_Subcult_Beastmen_&_FactionSecondary_Beastmen_Lord_2_Negative	wh_dlc03_sc_bst_beastmen
wh_dlc03_diplomacy_Subcult_Beastmen_&_FactionSecondary_Beastmen_Lord_2_OtherFactionBeastmen	wh_dlc03_sc_bst_beastmen
wh_dlc03_diplomacy_Subcult_Beastmen_&_FactionSecondary_Beastmen_Lord_2_OtherFactionBeastmen_&_Negative	wh_dlc03_sc_bst_beastmen
wh_dlc03_diplomacy_Subcult_Beastmen_&_FactionSecondary_Beastmen_Lord_2_OtherFactionBeastmen_&_Positive	wh_dlc03_sc_bst_beastmen
wh_dlc03_diplomacy_Subcult_Beastmen_&_FactionSecondary_Beastmen_Lord_2_OtherFactionBretonnia	wh_dlc03_sc_bst_beastmen
wh_dlc03_diplomacy_Subcult_Beastmen_&_FactionSecondary_Beastmen_Lord_2_OtherFactionBretonnia_&_Negative	wh_dlc03_sc_bst_beastmen
wh_dlc03_diplomacy_Subcult_Beastmen_&_FactionSecondary_Beastmen_Lord_2_OtherFactionBretonnia_&_Positive	wh_dlc03_sc_bst_beastmen
wh_dlc03_diplomacy_Subcult_Beastmen_&_FactionSecondary_Beastmen_Lord_2_OtherFactionChaos	wh_dlc03_sc_bst_beastmen
wh_dlc03_diplomacy_Subcult_Beastmen_&_FactionSecondary_Beastmen_Lord_2_OtherFactionChaos_&_Negative	wh_dlc03_sc_bst_beastmen
wh_dlc03_diplomacy_Subcult_Beastmen_&_FactionSecondary_Beastmen_Lord_2_OtherFactionChaos_&_Positive	wh_dlc03_sc_bst_beastmen
wh_dlc03_diplomacy_Subcult_Beastmen_&_FactionSecondary_Beastmen_Lord_2_OtherFactionDwarf	wh_dlc03_sc_bst_beastmen
wh_dlc03_diplomacy_Subcult_Beastmen_&_FactionSecondary_Beastmen_Lord_2_OtherFactionDwarf_&_Negative	wh_dlc03_sc_bst_beastmen
wh_dlc03_diplomacy_Subcult_Beastmen_&_FactionSecondary_Beastmen_Lord_2_OtherFactionDwarf_&_Positive	wh_dlc03_sc_bst_beastmen
wh_dlc03_diplomacy_Subcult_Beastmen_&_FactionSecondary_Beastmen_Lord_2_OtherFactionEmpire	wh_dlc03_sc_bst_beastmen
wh_dlc03_diplomacy_Subcult_Beastmen_&_FactionSecondary_Beastmen_Lord_2_OtherFactionEmpire_&_Negative	wh_dlc03_sc_bst_beastmen
wh_dlc03_diplomacy_Subcult_Beastmen_&_FactionSecondary_Beastmen_Lord_2_OtherFactionEmpire_&_Positive	wh_dlc03_sc_bst_beastmen
wh_dlc03_diplomacy_Subcult_Beastmen_&_FactionSecondary_Beastmen_Lord_2_OtherFactionGreenskin	wh_dlc03_sc_bst_beastmen
wh_dlc03_diplomacy_Subcult_Beastmen_&_FactionSecondary_Beastmen_Lord_2_OtherFactionGreenskin_&_Negative	wh_dlc03_sc_bst_beastmen
wh_dlc03_diplomacy_Subcult_Beastmen_&_FactionSecondary_Beastmen_Lord_2_OtherFactionGreenskin_&_Positive	wh_dlc03_sc_bst_beastmen
wh_dlc03_diplomacy_Subcult_Beastmen_&_FactionSecondary_Beastmen_Lord_2_OtherFactionVamp	wh_dlc03_sc_bst_beastmen
wh_dlc03_diplomacy_Subcult_Beastmen_&_FactionSecondary_Beastmen_Lord_2_OtherFactionVamp_&_Negative	wh_dlc03_sc_bst_beastmen
wh_dlc03_diplomacy_Subcult_Beastmen_&_FactionSecondary_Beastmen_Lord_2_OtherFactionVamp_&_Positive	wh_dlc03_sc_bst_beastmen
wh_dlc03_diplomacy_Subcult_Beastmen_&_FactionSecondary_Beastmen_Lord_2_Positive	wh_dlc03_sc_bst_beastmen
wh_dlc03_diplomacy_Subcult_Beastmen_&_Negative	wh_dlc03_sc_bst_beastmen
wh_dlc03_diplomacy_Subcult_Beastmen_&_OtherFactionBeastmen	wh_dlc03_sc_bst_beastmen
wh_dlc03_diplomacy_Subcult_Beastmen_&_OtherFactionBeastmen_&_Negative	wh_dlc03_sc_bst_beastmen
wh_dlc03_diplomacy_Subcult_Beastmen_&_OtherFactionBeastmen_&_Positive	wh_dlc03_sc_bst_beastmen
wh_dlc03_diplomacy_Subcult_Beastmen_&_OtherFactionBretonnia	wh_dlc03_sc_bst_beastmen
wh_dlc03_diplomacy_Subcult_Beastmen_&_OtherFactionBretonnia_&_Negative	wh_dlc03_sc_bst_beastmen
wh_dlc03_diplomacy_Subcult_Beastmen_&_OtherFactionBretonnia_&_Positive	wh_dlc03_sc_bst_beastmen
wh_dlc03_diplomacy_Subcult_Beastmen_&_OtherFactionChaos	wh_dlc03_sc_bst_beastmen
wh_dlc03_diplomacy_Subcult_Beastmen_&_OtherFactionChaos_&_Negative	wh_dlc03_sc_bst_beastmen
wh_dlc03_diplomacy_Subcult_Beastmen_&_OtherFactionChaos_&_Positive	wh_dlc03_sc_bst_beastmen
wh_dlc03_diplomacy_Subcult_Beastmen_&_OtherFactionDwarf	wh_dlc03_sc_bst_beastmen
wh_dlc03_diplomacy_Subcult_Beastmen_&_OtherFactionDwarf_&_Negative	wh_dlc03_sc_bst_beastmen
wh_dlc03_diplomacy_Subcult_Beastmen_&_OtherFactionDwarf_&_Positive	wh_dlc03_sc_bst_beastmen
wh_dlc03_diplomacy_Subcult_Beastmen_&_OtherFactionEmpire	wh_dlc03_sc_bst_beastmen
wh_dlc03_diplomacy_Subcult_Beastmen_&_OtherFactionEmpire_&_Negative	wh_dlc03_sc_bst_beastmen
wh_dlc03_diplomacy_Subcult_Beastmen_&_OtherFactionEmpire_&_Positive	wh_dlc03_sc_bst_beastmen
wh_dlc03_diplomacy_Subcult_Beastmen_&_OtherFactionGreenskin	wh_dlc03_sc_bst_beastmen
wh_dlc03_diplomacy_Subcult_Beastmen_&_OtherFactionGreenskin_&_Negative	wh_dlc03_sc_bst_beastmen
wh_dlc03_diplomacy_Subcult_Beastmen_&_OtherFactionGreenskin_&_Positive	wh_dlc03_sc_bst_beastmen
wh_dlc03_diplomacy_Subcult_Beastmen_&_OtherFactionVamp	wh_dlc03_sc_bst_beastmen
wh_dlc03_diplomacy_Subcult_Beastmen_&_OtherFactionVamp_&_Negative	wh_dlc03_sc_bst_beastmen
wh_dlc03_diplomacy_Subcult_Beastmen_&_OtherFactionVamp_&_Positive	wh_dlc03_sc_bst_beastmen
wh_dlc03_diplomacy_Subcult_Beastmen_&_Positive	wh_dlc03_sc_bst_beastmen
wh_dlc05_diplomacy_Subcult_WoodElves	wh_dlc05_sc_wef_wood_elves
wh_dlc05_diplomacy_Subcult_WoodElves_&_Negative	wh_dlc05_sc_wef_wood_elves
wh_dlc05_diplomacy_Subcult_WoodElves_&_OtherFactionBeastmen	wh_dlc05_sc_wef_wood_elves
wh_dlc05_diplomacy_Subcult_WoodElves_&_OtherFactionBeastmen_&_Negative	wh_dlc05_sc_wef_wood_elves
wh_dlc05_diplomacy_Subcult_WoodElves_&_OtherFactionBeastmen_&_Positive	wh_dlc05_sc_wef_wood_elves
wh_dlc05_diplomacy_Subcult_WoodElves_&_OtherFactionBretonnia	wh_dlc05_sc_wef_wood_elves
wh_dlc05_diplomacy_Subcult_WoodElves_&_OtherFactionBretonnia_&_Negative	wh_dlc05_sc_wef_wood_elves
wh_dlc05_diplomacy_Subcult_WoodElves_&_OtherFactionBretonnia_&_Positive	wh_dlc05_sc_wef_wood_elves
wh_dlc05_diplomacy_Subcult_WoodElves_&_OtherFactionChaos	wh_dlc05_sc_wef_wood_elves
wh_dlc05_diplomacy_Subcult_WoodElves_&_OtherFactionChaos_&_Negative	wh_dlc05_sc_wef_wood_elves
wh_dlc05_diplomacy_Subcult_WoodElves_&_OtherFactionChaos_&_Positive	wh_dlc05_sc_wef_wood_elves
wh_dlc05_diplomacy_Subcult_WoodElves_&_OtherFactionDwarf	wh_dlc05_sc_wef_wood_elves
wh_dlc05_diplomacy_Subcult_WoodElves_&_OtherFactionDwarf_&_Negative	wh_dlc05_sc_wef_wood_elves
wh_dlc05_diplomacy_Subcult_WoodElves_&_OtherFactionDwarf_&_Positive	wh_dlc05_sc_wef_wood_elves
wh_dlc05_diplomacy_Subcult_WoodElves_&_OtherFactionEmpire	wh_dlc05_sc_wef_wood_elves
wh_dlc05_diplomacy_Subcult_WoodElves_&_OtherFactionEmpire_&_Negative	wh_dlc05_sc_wef_wood_elves
wh_dlc05_diplomacy_Subcult_WoodElves_&_OtherFactionEmpire_&_Positive	wh_dlc05_sc_wef_wood_elves
wh_dlc05_diplomacy_Subcult_WoodElves_&_OtherFactionGreenskin	wh_dlc05_sc_wef_wood_elves
wh_dlc05_diplomacy_Subcult_WoodElves_&_OtherFactionGreenskin_&_Negative	wh_dlc05_sc_wef_wood_elves
wh_dlc05_diplomacy_Subcult_WoodElves_&_OtherFactionGreenskin_&_Positive	wh_dlc05_sc_wef_wood_elves
wh_dlc05_diplomacy_Subcult_WoodElves_&_OtherFactionVamp	wh_dlc05_sc_wef_wood_elves
wh_dlc05_diplomacy_Subcult_WoodElves_&_OtherFactionVamp_&_Negative	wh_dlc05_sc_wef_wood_elves
wh_dlc05_diplomacy_Subcult_WoodElves_&_OtherFactionVamp_&_Positive	wh_dlc05_sc_wef_wood_elves
wh_dlc05_diplomacy_Subcult_WoodElves_&_OtherFactionWoodElf	wh_dlc05_sc_wef_wood_elves
wh_dlc05_diplomacy_Subcult_WoodElves_&_OtherFactionWoodElf_&_Negative	wh_dlc05_sc_wef_wood_elves
wh_dlc05_diplomacy_Subcult_WoodElves_&_OtherFactionWoodElf_&_Positive	wh_dlc05_sc_wef_wood_elves
wh_dlc05_diplomacy_Subcult_WoodElves_&_Positive	wh_dlc05_sc_wef_wood_elves
wh_dlc05_stance_csc_woodelves	wh_dlc05_sc_wef_wood_elves
wh_stance_csc_chaos	wh_main_sc_chs_chaos
wh_stance_csc_norsca	wh_main_sc_nor_norsca
