videos_tables
7
video_name	video_type	audio_tracks	script_ref
Front_end_selection_movies/alberic_front_end	FULLSCREEN_INTRO	1	0
Front_end_selection_movies/archaon_front_end	FULLSCREEN_INTRO	1	0
Front_end_selection_movies/azhag_front_end	FULLSCREEN_INTRO	1	0
Front_end_selection_movies/balthazar_front_end	FULLSCREEN_INTRO	1	0
Front_end_selection_movies/belegar_front_end	FULLSCREEN_INTRO	1	0
Front_end_selection_movies/def_malekith	FULLSCREEN_INTRO	1	0
Front_end_selection_movies/def_morathi	FULLSCREEN_INTRO	1	0
Front_end_selection_movies/durthu_front_end	FULLSCREEN_INTRO	1	0
Front_end_selection_movies/fay_front_end	FULLSCREEN_INTRO	1	0
Front_end_selection_movies/franz_front_end	FULLSCREEN_INTRO	1	0
Front_end_selection_movies/grimgor_front_end	FULLSCREEN_INTRO	1	0
Front_end_selection_movies/grombrindal_front_end	FULLSCREEN_INTRO	1	0
Front_end_selection_movies/hef_teclis	FULLSCREEN_INTRO	1	0
Front_end_selection_movies/hef_tyrion	FULLSCREEN_INTRO	1	0
Front_end_selection_movies/heinrich_front_end	FULLSCREEN_INTRO	1	0
Front_end_selection_movies/helman_front_end	FULLSCREEN_INTRO	1	0
Front_end_selection_movies/isabella_front_end	FULLSCREEN_INTRO	1	0
Front_end_selection_movies/khazrak_front_end	FULLSCREEN_INTRO	1	0
Front_end_selection_movies/kholek_front_end	FULLSCREEN_INTRO	1	0
Front_end_selection_movies/louen_front_end	FULLSCREEN_INTRO	1	0
Front_end_selection_movies/lzd_kroqgar	FULLSCREEN_INTRO	1	0
Front_end_selection_movies/lzd_mazdamundi	FULLSCREEN_INTRO	1	0
Front_end_selection_movies/malagor_front_end	FULLSCREEN_INTRO	1	0
Front_end_selection_movies/mannfred_front_end	FULLSCREEN_INTRO	1	0
Front_end_selection_movies/morghur_front_end	FULLSCREEN_INTRO	1	0
Front_end_selection_movies/orion_front_end	FULLSCREEN_INTRO	1	0
Front_end_selection_movies/sigvald_front_end	FULLSCREEN_INTRO	1	0
Front_end_selection_movies/skarsnik_front_end	FULLSCREEN_INTRO	1	0
Front_end_selection_movies/skv_queek	FULLSCREEN_INTRO	1	0
Front_end_selection_movies/skv_skrolk	FULLSCREEN_INTRO	1	0
Front_end_selection_movies/thorgrim_front_end	FULLSCREEN_INTRO	1	0
Front_end_selection_movies/ungrim_front_end	FULLSCREEN_INTRO	1	0
Front_end_selection_movies/vlad_front_end	FULLSCREEN_INTRO	1	0
Front_end_selection_movies/volkmar_front_end	FULLSCREEN_INTRO	1	0
Front_end_selection_movies/wurrzag_front_end	FULLSCREEN_INTRO	1	0
MainMenu	FULLSCREEN_INTRO	1	0
SEGA_logo_sting_HD	FULLSCREEN_INTRO	1	0
Warhammer/chs_invasion	FULLSCREEN_INTRO	1	19
Warhammer/chs_rises	FULLSCREEN_INTRO	1	18
Warhammer/faction_select_argwylon	FULLSCREEN_INTRO	1	0
Warhammer/faction_select_belegar	FULLSCREEN_INTRO	1	0
Warhammer/faction_select_brt	FULLSCREEN_INTRO	1	0
Warhammer/faction_select_brt_bordeleaux	FULLSCREEN_INTRO	1	0
Warhammer/faction_select_brt_carcassonne	FULLSCREEN_INTRO	1	0
Warhammer/faction_select_bst	FULLSCREEN_INTRO	1	0
Warhammer/faction_select_bst_mini	FULLSCREEN_INTRO	1	0
Warhammer/faction_select_chs	FULLSCREEN_INTRO	1	0
Warhammer/faction_select_dwf	FULLSCREEN_INTRO	1	0
Warhammer/faction_select_emp	FULLSCREEN_INTRO	1	0
Warhammer/faction_select_grn	FULLSCREEN_INTRO	1	0
Warhammer/faction_select_mini_argwylon	FULLSCREEN_INTRO	1	0
Warhammer/faction_select_mini_wef	FULLSCREEN_INTRO	1	0
Warhammer/faction_select_skarsnik	FULLSCREEN_INTRO	1	0
Warhammer/faction_select_vmp	FULLSCREEN_INTRO	1	0
Warhammer/faction_select_vmp_von_carstein	FULLSCREEN_INTRO	1	0
Warhammer/faction_select_wef	FULLSCREEN_INTRO	1	0
Warhammer/faction_select_wurrzag	FULLSCREEN_INTRO	1	0
Warhammer/front_end_bst_mini	FULLSCREEN_INTRO	1	0
Warhammer/front_end_grand_campaign	FULLSCREEN_INTRO	1	0
Warhammer/front_end_vortex_campaign	FULLSCREEN_INTRO	1	0
Warhammer/front_end_wef_mini	FULLSCREEN_INTRO	1	0
Warhammer/race_intro_brt	FULLSCREEN_INTRO	1	24
Warhammer/race_intro_bst	FULLSCREEN_INTRO	1	20
Warhammer/race_intro_bst_mini	FULLSCREEN_INTRO	1	21
Warhammer/race_intro_chs	FULLSCREEN_INTRO	1	13
Warhammer/race_intro_dwf	FULLSCREEN_INTRO	1	14
Warhammer/race_intro_emp	FULLSCREEN_INTRO	1	15
Warhammer/race_intro_grn	FULLSCREEN_INTRO	1	16
Warhammer/race_intro_vmp	FULLSCREEN_INTRO	1	17
Warhammer/race_intro_wef	FULLSCREEN_INTRO	1	22
Warhammer/race_intro_wef_mini	FULLSCREEN_INTRO	1	23
advert1	FULLSCREEN_INTRO	1	0
advert2	FULLSCREEN_INTRO	1	0
army_morale_down	CAMPAIGN_ESTABLISH	1	0
army_morale_up	CAMPAIGN_ESTABLISH	1	0
army_morale_up_grn	CAMPAIGN_ESTABLISH	1	0
army_special_spawnings	CAMPAIGN_ESTABLISH	1	0
attrition_chaos_wastes	CAMPAIGN_ESTABLISH	1	0
attrition_desert	CAMPAIGN_ESTABLISH	1	0
attrition_disease	CAMPAIGN_ESTABLISH	1	0
attrition_mountain	CAMPAIGN_ESTABLISH	1	0
attrition_sea	CAMPAIGN_ESTABLISH	1	0
attrition_snow	CAMPAIGN_ESTABLISH	1	0
attrition_swamp	CAMPAIGN_ESTABLISH	1	0
attrition_vampire_territory	CAMPAIGN_ESTABLISH	1	0
besieged	CAMPAIGN_ESTABLISH	1	0
black_ark_created	CAMPAIGN_ESTABLISH	1	0
black_ark_destroyed	CAMPAIGN_ESTABLISH	1	0
blessing_of_the_lady	CAMPAIGN_ESTABLISH	1	0
blessing_of_the_lady_removed	CAMPAIGN_ESTABLISH	1	0
blockaded	CAMPAIGN_ESTABLISH	1	0
bray_herd_ceases	CAMPAIGN_ESTABLISH	1	0
bray_herd_rises	CAMPAIGN_ESTABLISH	1	0
carnage_charge	CAMPAIGN_ESTABLISH	1	0
carnage_magic	CAMPAIGN_ESTABLISH	1	0
carnage_weapons	CAMPAIGN_ESTABLISH	1	0
celebration	CAMPAIGN_ESTABLISH	1	0
chaos_doom_tide	CAMPAIGN_ESTABLISH	1	0
chaos_invasion	CAMPAIGN_ESTABLISH	1	0
chaos_rising	CAMPAIGN_ESTABLISH	1	0
chaos_stirs	CAMPAIGN_ESTABLISH	1	0
civilisation_down	CAMPAIGN_ESTABLISH	1	0
civilisation_up	CAMPAIGN_ESTABLISH	1	0
court_intrigue_1	CAMPAIGN_ESTABLISH	1	0
court_intrigue_2	CAMPAIGN_ESTABLISH	1	0
court_intrigue_3	CAMPAIGN_ESTABLISH	1	0
diplomacy	CAMPAIGN_ESTABLISH	1	0
epithets	CAMPAIGN_ESTABLISH	1	0
everchosen	CAMPAIGN_ESTABLISH	1	0
faction	CAMPAIGN_ESTABLISH	1	0
front_end_faction_select/def_faction	FULLSCREEN_INTRO	1	0
front_end_faction_select/hef_faction	FULLSCREEN_INTRO	1	0
front_end_faction_select/lzd_faction	FULLSCREEN_INTRO	1	0
front_end_faction_select/skv_faction	FULLSCREEN_INTRO	1	0
full_moon	CAMPAIGN_ESTABLISH	1	0
full_moon_loop	CAMPAIGN_ESTABLISH	1	0
funeral	CAMPAIGN_ESTABLISH	1	0
generic	CAMPAIGN_ESTABLISH	1	0
green_knight_appears	CAMPAIGN_ESTABLISH	1	0
green_knight_leaves	CAMPAIGN_ESTABLISH	1	0
land_defeat	CAMPAIGN_ESTABLISH	1	0
land_victory	CAMPAIGN_ESTABLISH	1	0
lord_defects	CAMPAIGN_ESTABLISH	1	0
lord_loyalty_low	CAMPAIGN_ESTABLISH	1	0
lunar_eclipse	CAMPAIGN_ESTABLISH	1	0
lunar_eclipse_loop	CAMPAIGN_ESTABLISH	1	0
messenger	CAMPAIGN_ESTABLISH	1	0
politics	CAMPAIGN_ESTABLISH	1	0
ritual_complete	CAMPAIGN_ESTABLISH	1	0
ritual_failed	CAMPAIGN_ESTABLISH	1	0
ritual_interrupted	CAMPAIGN_ESTABLISH	1	0
ritual_started	CAMPAIGN_ESTABLISH	1	0
settlement_lost	CAMPAIGN_ESTABLISH	1	0
solar_eclipse	CAMPAIGN_ESTABLISH	1	0
solar_eclipse_loop	CAMPAIGN_ESTABLISH	1	0
spell_previews/beast/wh_dlc03_spell_beast_flock_of_doom	VIDEO_TUTORIAL	1	0
spell_previews/beast/wh_dlc03_spell_beast_panns_impenetrable_pelt	VIDEO_TUTORIAL	1	0
spell_previews/beast/wh_dlc03_spell_beast_the_amber_spear	VIDEO_TUTORIAL	1	0
spell_previews/beast/wh_dlc03_spell_beast_the_curse_of_anraheir	VIDEO_TUTORIAL	1	0
spell_previews/beast/wh_dlc03_spell_beast_transformation_of_kadon	VIDEO_TUTORIAL	1	0
spell_previews/beast/wh_dlc03_spell_beast_wyssans_wildform	VIDEO_TUTORIAL	1	0
spell_previews/big_waaagh/wh_main_spell_big_waaagh_brain_bursta	VIDEO_TUTORIAL	1	0
spell_previews/big_waaagh/wh_main_spell_big_waaagh_eadbutt	VIDEO_TUTORIAL	1	0
spell_previews/big_waaagh/wh_main_spell_big_waaagh_ere_we_go	VIDEO_TUTORIAL	1	0
spell_previews/big_waaagh/wh_main_spell_big_waaagh_fists_of_gork	VIDEO_TUTORIAL	1	0
spell_previews/big_waaagh/wh_main_spell_big_waaagh_foot_of_gork	VIDEO_TUTORIAL	1	0
spell_previews/big_waaagh/wh_main_spell_big_waaagh_gaze_of_mork	VIDEO_TUTORIAL	1	0
spell_previews/dark/wh2_main_spell_dark_magic_bladewind	VIDEO_TUTORIAL	1	0
spell_previews/dark/wh2_main_spell_dark_magic_chillwind	VIDEO_TUTORIAL	1	0
spell_previews/dark/wh2_main_spell_dark_magic_doombolt	VIDEO_TUTORIAL	1	0
spell_previews/dark/wh2_main_spell_dark_magic_power_of_darkness	VIDEO_TUTORIAL	1	0
spell_previews/dark/wh2_main_spell_dark_magic_soul_stealer	VIDEO_TUTORIAL	1	0
spell_previews/dark/wh2_main_spell_dark_magic_word_of_pain	VIDEO_TUTORIAL	1	0
spell_previews/death/wh_main_spell_death_aspect_of_the_dreadknight	VIDEO_TUTORIAL	1	0
spell_previews/death/wh_main_spell_death_doom_and_darkness	VIDEO_TUTORIAL	1	0
spell_previews/death/wh_main_spell_death_soulblight	VIDEO_TUTORIAL	1	0
spell_previews/death/wh_main_spell_death_spirit_leech	VIDEO_TUTORIAL	1	0
spell_previews/death/wh_main_spell_death_the_fate_of_bjuna	VIDEO_TUTORIAL	1	0
spell_previews/death/wh_main_spell_death_the_purple_sun_of_xereus	VIDEO_TUTORIAL	1	0
spell_previews/fire/wh_main_spell_fire_cascading_fire_cloak	VIDEO_TUTORIAL	1	0
spell_previews/fire/wh_main_spell_fire_fireball	VIDEO_TUTORIAL	1	0
spell_previews/fire/wh_main_spell_fire_flame_storm	VIDEO_TUTORIAL	1	0
spell_previews/fire/wh_main_spell_fire_flaming_sword_of_rhuin	VIDEO_TUTORIAL	1	0
spell_previews/fire/wh_main_spell_fire_piercing_bolts_of_burning	VIDEO_TUTORIAL	1	0
spell_previews/fire/wh_main_spell_fire_the_burning_head	VIDEO_TUTORIAL	1	0
spell_previews/heaven/wh_main_spell_heavens_chain_lightning	VIDEO_TUTORIAL	1	0
spell_previews/heaven/wh_main_spell_heavens_comet_of_casandora	VIDEO_TUTORIAL	1	0
spell_previews/heaven/wh_main_spell_heavens_curse_of_the_midnight_wind	VIDEO_TUTORIAL	1	0
spell_previews/heaven/wh_main_spell_heavens_harmonic_convergence	VIDEO_TUTORIAL	1	0
spell_previews/heaven/wh_main_spell_heavens_urannons_thunderbolt	VIDEO_TUTORIAL	1	0
spell_previews/heaven/wh_main_spell_heavens_wind_blast	VIDEO_TUTORIAL	1	0
spell_previews/high/wh2_main_spell_high_magic_apotheosis	VIDEO_TUTORIAL	1	0
spell_previews/high/wh2_main_spell_high_magic_arcane_unforging	VIDEO_TUTORIAL	1	0
spell_previews/high/wh2_main_spell_high_magic_fiery_convocation	VIDEO_TUTORIAL	1	0
spell_previews/high/wh2_main_spell_high_magic_hand_of_glory	VIDEO_TUTORIAL	1	0
spell_previews/high/wh2_main_spell_high_magic_soul_quench	VIDEO_TUTORIAL	1	0
spell_previews/high/wh2_main_spell_high_magic_tempest	VIDEO_TUTORIAL	1	0
spell_previews/life/wh_dlc05_spell_life_awakening_of_the_wood	VIDEO_TUTORIAL	1	0
spell_previews/life/wh_dlc05_spell_life_earth_blood	VIDEO_TUTORIAL	1	0
spell_previews/life/wh_dlc05_spell_life_flesh_to_stone	VIDEO_TUTORIAL	1	0
spell_previews/life/wh_dlc05_spell_life_regrowth	VIDEO_TUTORIAL	1	0
spell_previews/life/wh_dlc05_spell_life_shield_of_thorns	VIDEO_TUTORIAL	1	0
spell_previews/life/wh_dlc05_spell_life_the_dwellers_below	VIDEO_TUTORIAL	1	0
spell_previews/light/wh_main_spell_light_banishment	VIDEO_TUTORIAL	1	0
spell_previews/light/wh_main_spell_light_bironas_timewarp	VIDEO_TUTORIAL	1	0
spell_previews/light/wh_main_spell_light_light_of_battle	VIDEO_TUTORIAL	1	0
spell_previews/light/wh_main_spell_light_net_of_amyntok	VIDEO_TUTORIAL	1	0
spell_previews/light/wh_main_spell_light_phas_protection	VIDEO_TUTORIAL	1	0
spell_previews/light/wh_main_spell_light_shems_burning_gaze	VIDEO_TUTORIAL	1	0
spell_previews/lil_waaagh/wh_main_spell_lil_waaagh_curse_of_da_bad_moon	VIDEO_TUTORIAL	1	0
spell_previews/lil_waaagh/wh_main_spell_lil_waaagh_gorkll_fix_it	VIDEO_TUTORIAL	1	0
spell_previews/lil_waaagh/wh_main_spell_lil_waaagh_itchy_nuisance	VIDEO_TUTORIAL	1	0
spell_previews/lil_waaagh/wh_main_spell_lil_waaagh_night_shroud	VIDEO_TUTORIAL	1	0
spell_previews/lil_waaagh/wh_main_spell_lil_waaagh_sneaky_stabbin	VIDEO_TUTORIAL	1	0
spell_previews/lil_waaagh/wh_main_spell_lil_waaagh_vindictive_glare	VIDEO_TUTORIAL	1	0
spell_previews/metal/wh_main_spell_metal_final_transmutation	VIDEO_TUTORIAL	1	0
spell_previews/metal/wh_main_spell_metal_gehennas_golden_hounds	VIDEO_TUTORIAL	1	0
spell_previews/metal/wh_main_spell_metal_glittering_robe	VIDEO_TUTORIAL	1	0
spell_previews/metal/wh_main_spell_metal_plague_of_rust	VIDEO_TUTORIAL	1	0
spell_previews/metal/wh_main_spell_metal_searing_doom	VIDEO_TUTORIAL	1	0
spell_previews/metal/wh_main_spell_metal_transmutation_of_lead	VIDEO_TUTORIAL	1	0
spell_previews/plague/wh2_main_spell_plague_bless_with_filth	VIDEO_TUTORIAL	1	0
spell_previews/plague/wh2_main_spell_plague_pestilent_birth	VIDEO_TUTORIAL	1	0
spell_previews/plague/wh2_main_spell_plague_pestilent_breath	VIDEO_TUTORIAL	1	0
spell_previews/plague/wh2_main_spell_plague_plague	VIDEO_TUTORIAL	1	0
spell_previews/plague/wh2_main_spell_plague_the_dreaded_thirteenth_spell	VIDEO_TUTORIAL	1	0
spell_previews/plague/wh2_main_spell_plague_vermintide	VIDEO_TUTORIAL	1	0
spell_previews/plague/wh2_main_spell_plague_wither	VIDEO_TUTORIAL	1	0
spell_previews/ruin/wh2_main_spell_ruin_cracks_call	VIDEO_TUTORIAL	1	0
spell_previews/ruin/wh2_main_spell_ruin_death_frenzy	VIDEO_TUTORIAL	1	0
spell_previews/ruin/wh2_main_spell_ruin_howling_warpgale	VIDEO_TUTORIAL	1	0
spell_previews/ruin/wh2_main_spell_ruin_scorch	VIDEO_TUTORIAL	1	0
spell_previews/ruin/wh2_main_spell_ruin_skitterleap	VIDEO_TUTORIAL	1	0
spell_previews/ruin/wh2_main_spell_ruin_warp_lightning	VIDEO_TUTORIAL	1	0
spell_previews/shadows/wh_dlc05_spell_shadows_melkoths_mystifying_miasma	VIDEO_TUTORIAL	1	0
spell_previews/shadows/wh_dlc05_spell_shadows_okkams_mindrazor	VIDEO_TUTORIAL	1	0
spell_previews/shadows/wh_dlc05_spell_shadows_pits_of_shades	VIDEO_TUTORIAL	1	0
spell_previews/shadows/wh_dlc05_spell_shadows_the_enfeebling_foe	VIDEO_TUTORIAL	1	0
spell_previews/shadows/wh_dlc05_spell_shadows_the_penumbral_pendulum	VIDEO_TUTORIAL	1	0
spell_previews/shadows/wh_dlc05_spell_shadows_withering	VIDEO_TUTORIAL	1	0
spell_previews/vampire/wh_dlc04_spell_vampire_awaken_from_the_grave	VIDEO_TUTORIAL	1	0
spell_previews/vampire/wh_dlc04_spell_vampire_command_of_the_unliving	VIDEO_TUTORIAL	1	0
spell_previews/vampire/wh_main_spell_vampires_curse_of_years	VIDEO_TUTORIAL	1	0
spell_previews/vampire/wh_main_spell_vampires_gaze_of_nagash	VIDEO_TUTORIAL	1	0
spell_previews/vampire/wh_main_spell_vampires_invocation_of_nehek	VIDEO_TUTORIAL	1	0
spell_previews/vampire/wh_main_spell_vampires_raise_dead	VIDEO_TUTORIAL	1	0
spell_previews/vampire/wh_main_spell_vampires_vanhels_danse_macabre	VIDEO_TUTORIAL	1	0
spell_previews/vampire/wh_main_spell_vampires_wind_of_death	VIDEO_TUTORIAL	1	0
spell_previews/wild/wh_dlc03_spell_wild_bray_scream	VIDEO_TUTORIAL	1	0
spell_previews/wild/wh_dlc03_spell_wild_devolve	VIDEO_TUTORIAL	1	0
spell_previews/wild/wh_dlc03_spell_wild_mantle_of_ghorok	VIDEO_TUTORIAL	1	0
spell_previews/wild/wh_dlc03_spell_wild_savage_dominion	VIDEO_TUTORIAL	1	0
spell_previews/wild/wh_dlc03_spell_wild_traitor_kin	VIDEO_TUTORIAL	1	0
spell_previews/wild/wh_dlc03_spell_wild_viletide	VIDEO_TUTORIAL	1	0
startup_movie_01	FULLSCREEN_INTRO	1	12
startup_movie_02	FULLSCREEN_INTRO	1	0
startup_movie_03	FULLSCREEN_INTRO	1	0
todbringer_defeated	CAMPAIGN_ESTABLISH	1	0
treachery_of_tzeenth	CAMPAIGN_ESTABLISH	1	0
warhammer2/def/def_horned_rat	FULLSCREEN_INTRO	1	30
warhammer2/def/def_intro	FULLSCREEN_INTRO	1	25
warhammer2/def/def_ritual_1	FULLSCREEN_INTRO	1	26
warhammer2/def/def_ritual_2	FULLSCREEN_INTRO	1	27
warhammer2/def/def_ritual_3	FULLSCREEN_INTRO	1	28
warhammer2/def/def_ritual_4	FULLSCREEN_INTRO	1	29
warhammer2/def/def_ritual_5	FULLSCREEN_INTRO	1	31
warhammer2/def/def_win	FULLSCREEN_INTRO	1	32
warhammer2/hef/hef_horned_rat	FULLSCREEN_INTRO	1	38
warhammer2/hef/hef_intro	FULLSCREEN_INTRO	1	33
warhammer2/hef/hef_ritual_1	FULLSCREEN_INTRO	1	34
warhammer2/hef/hef_ritual_2	FULLSCREEN_INTRO	1	35
warhammer2/hef/hef_ritual_3	FULLSCREEN_INTRO	1	36
warhammer2/hef/hef_ritual_4	FULLSCREEN_INTRO	1	37
warhammer2/hef/hef_ritual_5	FULLSCREEN_INTRO	1	39
warhammer2/hef/hef_win	FULLSCREEN_INTRO	1	40
warhammer2/lzd/lzd_horned_rat	FULLSCREEN_INTRO	1	46
warhammer2/lzd/lzd_intro	FULLSCREEN_INTRO	1	41
warhammer2/lzd/lzd_ritual_1	FULLSCREEN_INTRO	1	42
warhammer2/lzd/lzd_ritual_2	FULLSCREEN_INTRO	1	43
warhammer2/lzd/lzd_ritual_3	FULLSCREEN_INTRO	1	44
warhammer2/lzd/lzd_ritual_4	FULLSCREEN_INTRO	1	45
warhammer2/lzd/lzd_ritual_5	FULLSCREEN_INTRO	1	47
warhammer2/lzd/lzd_win	FULLSCREEN_INTRO	1	48
warhammer2/skv/skv_horned_rat	FULLSCREEN_INTRO	1	55
warhammer2/skv/skv_intro	FULLSCREEN_INTRO	1	49
warhammer2/skv/skv_ritual_1	FULLSCREEN_INTRO	1	50
warhammer2/skv/skv_ritual_2	FULLSCREEN_INTRO	1	51
warhammer2/skv/skv_ritual_3	FULLSCREEN_INTRO	1	52
warhammer2/skv/skv_ritual_4	FULLSCREEN_INTRO	1	53
warhammer2/skv/skv_ritual_5	FULLSCREEN_INTRO	1	56
warhammer2/skv/skv_win	FULLSCREEN_INTRO	1	57
warhammer2/skv_comet	FULLSCREEN_INTRO	1	54
wh2_desert_attrition	CAMPAIGN_ESTABLISH	1	0
wh2_disease_attrition	CAMPAIGN_ESTABLISH	1	0
wh2_jungle_attrition	CAMPAIGN_ESTABLISH	1	0
wh2_maelstorm_attrition	CAMPAIGN_ESTABLISH	1	0
wh2_naval_defeat	CAMPAIGN_ESTABLISH	1	0
wh2_naval_victory	CAMPAIGN_ESTABLISH	1	0
wh2_reef_attrition	CAMPAIGN_ESTABLISH	1	0
wh2_sea_encounters_1	CAMPAIGN_ESTABLISH	1	0
wh2_sea_encounters_2	CAMPAIGN_ESTABLISH	1	0
wh2_skaven_underworld	CAMPAIGN_ESTABLISH	1	0
wh2_storm_attrition	CAMPAIGN_ESTABLISH	1	0
wh2_treasure_hunt	CAMPAIGN_ESTABLISH	1	0
wh2_treasure_hunt_2	CAMPAIGN_ESTABLISH	1	0
wh2_treasure_hunt_3	CAMPAIGN_ESTABLISH	1	0
wh2_treasure_hunt_4	CAMPAIGN_ESTABLISH	1	0
winds_of_magic_change	CAMPAIGN_ESTABLISH	1	0
