building_chain_availability_sets_tables
0
building_chain	set_key
wh2_main_def_barracks	wh2_main_bas_def
wh2_main_def_beasts	wh2_main_bas_def
wh2_main_def_coldones	wh2_main_bas_def
wh2_main_def_defence_major	wh2_main_bas_def
wh2_main_def_defence_minor	wh2_main_bas_def
wh2_main_def_defence_norsca	wh2_main_bas_def
wh2_main_def_exiles	wh2_main_bas_def
wh2_main_def_farm	wh2_main_bas_def
wh2_main_def_industry	wh2_main_bas_def
wh2_main_def_murder	wh2_main_bas_def
wh2_main_def_order	wh2_main_bas_def
wh2_main_def_outpostnorsca_major	wh2_main_bas_def
wh2_main_def_outpostnorsca_major_coast	wh2_main_bas_def
wh2_main_def_outpostnorsca_minor	wh2_main_bas_def
wh2_main_def_outpostnorsca_minor_coast	wh2_main_bas_def
wh2_main_def_pleasure_cult	wh2_main_bas_def
wh2_main_def_port	wh2_main_bas_def
wh2_main_def_resource_animals	wh2_main_bas_def
wh2_main_def_resource_dyes	wh2_main_bas_def
wh2_main_def_resource_furs	wh2_main_bas_def
wh2_main_def_resource_gems	wh2_main_bas_def
wh2_main_def_resource_gold	wh2_main_bas_def
wh2_main_def_resource_iron	wh2_main_bas_def
wh2_main_def_resource_marble	wh2_main_bas_def
wh2_main_def_resource_medicine	wh2_main_bas_def
wh2_main_def_resource_obsidian	wh2_main_bas_def
wh2_main_def_resource_pasture	wh2_main_bas_def
wh2_main_def_resource_pottery	wh2_main_bas_def
wh2_main_def_resource_salt	wh2_main_bas_def
wh2_main_def_resource_spices	wh2_main_bas_def
wh2_main_def_resource_wine	wh2_main_bas_def
wh2_main_def_resource_wood	wh2_main_bas_def
wh2_main_def_riders	wh2_main_bas_def
wh2_main_def_roads	wh2_main_bas_def
wh2_main_def_settlement_major	wh2_main_bas_def
wh2_main_def_settlement_major_coast	wh2_main_bas_def
wh2_main_def_settlement_minor	wh2_main_bas_def
wh2_main_def_settlement_minor_coast	wh2_main_bas_def
wh2_main_def_slaves	wh2_main_bas_def
wh2_main_def_sorcery	wh2_main_bas_def
wh2_main_def_worship	wh2_main_bas_def
wh2_main_horde_def_beasts	wh2_main_bas_def
wh2_main_horde_def_bombardment_a	wh2_main_bas_def
wh2_main_horde_def_bombardment_b	wh2_main_bas_def
wh2_main_horde_def_bombardment_c	wh2_main_bas_def
wh2_main_horde_def_entertainment	wh2_main_bas_def
wh2_main_horde_def_military	wh2_main_bas_def
wh2_main_horde_def_settlement	wh2_main_bas_def
wh2_main_horde_def_slavery	wh2_main_bas_def
wh2_main_horde_def_sorcery	wh2_main_bas_def
wh2_main_horde_def_worship	wh2_main_bas_def
wh2_main_ritual_def	wh2_main_bas_def
wh2_main_special_altar_of_ultimate_darkness	wh2_main_bas_def
wh2_main_special_anlec_citadel_def	wh2_main_bas_def
wh2_main_special_chamber_of_visions	wh2_main_bas_def
wh2_main_special_clar_karond_lairs	wh2_main_bas_def
wh2_main_special_def_vauls_anvil	wh2_main_bas_def
wh2_main_special_fortress_gate_eagle_chaos	wh2_main_bas_def
wh2_main_special_fortress_gate_eagle_untainted	wh2_main_bas_def
wh2_main_special_fortress_gate_griffon_chaos	wh2_main_bas_def
wh2_main_special_fortress_gate_griffon_untainted	wh2_main_bas_def
wh2_main_special_fortress_gate_phoenix_chaos	wh2_main_bas_def
wh2_main_special_fortress_gate_phoenix_untainted	wh2_main_bas_def
wh2_main_special_fortress_gate_unicorn_chaos	wh2_main_bas_def
wh2_main_special_fortress_gate_unicorn_untainted	wh2_main_bas_def
wh2_main_special_ghrond_convent_of_sorcery	wh2_main_bas_def
wh2_main_special_glittering_tower	wh2_main_bas_def
wh2_main_special_golden_tower_of_the_gods_other	wh2_main_bas_def
wh2_main_special_hag_graef_mines_def	wh2_main_bas_def
wh2_main_special_hall_of_dragons	wh2_main_bas_def
wh2_main_special_har_ganeth_hellebron_palace	wh2_main_bas_def
wh2_main_special_har_ganeth_temple_of_khaine	wh2_main_bas_def
wh2_main_special_hexoatl_stellar_pyramids_other	wh2_main_bas_def
wh2_main_special_itza_emerald_pools	wh2_main_bas_def
wh2_main_special_karond_kar_slavers	wh2_main_bas_def
wh2_main_special_lothern_port_other	wh2_main_bas_def
wh2_main_special_naggarond_blackguard	wh2_main_bas_def
wh2_main_special_naggarond_witch_king	wh2_main_bas_def
wh2_main_special_pyramid_of_nagash_other	wh2_main_bas_def
wh2_main_special_quintex	wh2_main_bas_def
wh2_main_special_settlement_altdorf_def	wh2_main_bas_def
wh2_main_special_settlement_athel_loren_def	wh2_main_bas_def
wh2_main_special_settlement_black_crag_def	wh2_main_bas_def
wh2_main_special_settlement_castle_drakenhof_def	wh2_main_bas_def
wh2_main_special_settlement_colony_major_other	wh2_main_bas_def
wh2_main_special_settlement_colony_minor_other	wh2_main_bas_def
wh2_main_special_settlement_couronne_def	wh2_main_bas_def
wh2_main_special_settlement_eight_peaks_def	wh2_main_bas_def
wh2_main_special_settlement_hellpit_other	wh2_main_bas_def
wh2_main_special_settlement_hexoatl_def	wh2_main_bas_def
wh2_main_special_settlement_itza_def	wh2_main_bas_def
wh2_main_special_settlement_karaz_a_karak_def	wh2_main_bas_def
wh2_main_special_settlement_khemri_def	wh2_main_bas_def
wh2_main_special_settlement_kislev_def	wh2_main_bas_def
wh2_main_special_settlement_lahmia_def	wh2_main_bas_def
wh2_main_special_settlement_lothern_def	wh2_main_bas_def
wh2_main_special_settlement_miragliano_def	wh2_main_bas_def
wh2_main_special_settlement_naggarond	wh2_main_bas_def
wh2_main_special_settlement_skavenblight_other	wh2_main_bas_def
wh2_main_special_shrine_of_asuryan_def	wh2_main_bas_def
wh2_main_special_shrine_of_khaine_def	wh2_main_bas_def
wh2_main_special_tiranoc_palace_def	wh2_main_bas_def
wh2_main_special_tower_of_hoeth_def	wh2_main_bas_def
wh2_main_special_underworld_sea_gate	wh2_main_bas_def
wh2_main_special_yvresse_amphitheatre_def	wh2_main_bas_def
wh2_main_special_ziggurat_of_dawn_beacon	wh2_main_bas_def
wh2_main_special_ziggurat_of_dawn_beacon_chs	wh2_main_bas_def
wh2_main_wef_oak_of_ages_occupied	wh2_main_bas_def
wh_main_bretonnia_legendary_bordeleaux	wh2_main_bas_def
wh_main_special_bordeleaux_vineyards	wh2_main_bas_def
wh_main_special_erengrad_port	wh2_main_bas_def
wh_main_special_marienburg_port	wh2_main_bas_def
wh2_main_hef_barracks	wh2_main_bas_hef
wh2_main_hef_court	wh2_main_bas_hef
wh2_main_hef_defence_major	wh2_main_bas_hef
wh2_main_hef_defence_minor	wh2_main_bas_hef
wh2_main_hef_defence_norsca	wh2_main_bas_hef
wh2_main_hef_dragons	wh2_main_bas_hef
wh2_main_hef_embassy	wh2_main_bas_hef
wh2_main_hef_farm	wh2_main_bas_hef
wh2_main_hef_hunters	wh2_main_bas_hef
wh2_main_hef_industry	wh2_main_bas_hef
wh2_main_hef_mages	wh2_main_bas_hef
wh2_main_hef_order	wh2_main_bas_hef
wh2_main_hef_outpostnorsca_major	wh2_main_bas_hef
wh2_main_hef_outpostnorsca_major_coast	wh2_main_bas_hef
wh2_main_hef_outpostnorsca_minor	wh2_main_bas_hef
wh2_main_hef_outpostnorsca_minor_coast	wh2_main_bas_hef
wh2_main_hef_port	wh2_main_bas_hef
wh2_main_hef_resource_animals	wh2_main_bas_hef
wh2_main_hef_resource_dyes	wh2_main_bas_hef
wh2_main_hef_resource_furs	wh2_main_bas_hef
wh2_main_hef_resource_gems	wh2_main_bas_hef
wh2_main_hef_resource_gold	wh2_main_bas_hef
wh2_main_hef_resource_iron	wh2_main_bas_hef
wh2_main_hef_resource_marble	wh2_main_bas_hef
wh2_main_hef_resource_medicine	wh2_main_bas_hef
wh2_main_hef_resource_obsidian	wh2_main_bas_hef
wh2_main_hef_resource_pasture	wh2_main_bas_hef
wh2_main_hef_resource_pottery	wh2_main_bas_hef
wh2_main_hef_resource_salt	wh2_main_bas_hef
wh2_main_hef_resource_spices	wh2_main_bas_hef
wh2_main_hef_resource_wine	wh2_main_bas_hef
wh2_main_hef_resource_wood	wh2_main_bas_hef
wh2_main_hef_settlement_major	wh2_main_bas_hef
wh2_main_hef_settlement_major_coast	wh2_main_bas_hef
wh2_main_hef_settlement_minor	wh2_main_bas_hef
wh2_main_hef_settlement_minor_coast	wh2_main_bas_hef
wh2_main_hef_smith	wh2_main_bas_hef
wh2_main_hef_stables	wh2_main_bas_hef
wh2_main_hef_worship	wh2_main_bas_hef
wh2_main_ritual_hef	wh2_main_bas_hef
wh2_main_special_anlec_citadel_hef	wh2_main_bas_hef
wh2_main_special_chamber_of_visions	wh2_main_bas_hef
wh2_main_special_clar_karond_lairs_other	wh2_main_bas_hef
wh2_main_special_cothique_palace	wh2_main_bas_hef
wh2_main_special_def_vauls_anvil_hef	wh2_main_bas_hef
wh2_main_special_ellyrian_stables	wh2_main_bas_hef
wh2_main_special_everqueen_court	wh2_main_bas_hef
wh2_main_special_fortress_gate_eagle_hef	wh2_main_bas_hef
wh2_main_special_fortress_gate_griffon_hef	wh2_main_bas_hef
wh2_main_special_fortress_gate_phoenix_hef	wh2_main_bas_hef
wh2_main_special_fortress_gate_unicorn_hef	wh2_main_bas_hef
wh2_main_special_ghrond_convent_of_sorcery_hef	wh2_main_bas_hef
wh2_main_special_glittering_tower	wh2_main_bas_hef
wh2_main_special_golden_tower_of_the_gods_other	wh2_main_bas_hef
wh2_main_special_hag_graef_mines	wh2_main_bas_hef
wh2_main_special_hall_of_dragons	wh2_main_bas_hef
wh2_main_special_har_ganeth_temple_of_khaine_hef	wh2_main_bas_hef
wh2_main_special_hexoatl_stellar_pyramids_other	wh2_main_bas_hef
wh2_main_special_itza_emerald_pools	wh2_main_bas_hef
wh2_main_special_lothern_port	wh2_main_bas_hef
wh2_main_special_naggarond_witch_king_hef	wh2_main_bas_hef
wh2_main_special_phoenix_king_court	wh2_main_bas_hef
wh2_main_special_pyramid_of_nagash_other	wh2_main_bas_hef
wh2_main_special_quintex	wh2_main_bas_hef
wh2_main_special_settlement_altdorf_hef	wh2_main_bas_hef
wh2_main_special_settlement_athel_loren_hef	wh2_main_bas_hef
wh2_main_special_settlement_black_crag_hef	wh2_main_bas_hef
wh2_main_special_settlement_castle_drakenhof_hef	wh2_main_bas_hef
wh2_main_special_settlement_colony_major_hef	wh2_main_bas_hef
wh2_main_special_settlement_colony_minor_hef	wh2_main_bas_hef
wh2_main_special_settlement_couronne_hef	wh2_main_bas_hef
wh2_main_special_settlement_eight_peaks_hef	wh2_main_bas_hef
wh2_main_special_settlement_hellpit_other	wh2_main_bas_hef
wh2_main_special_settlement_hexoatl_hef	wh2_main_bas_hef
wh2_main_special_settlement_itza_hef	wh2_main_bas_hef
wh2_main_special_settlement_karaz_a_karak_hef	wh2_main_bas_hef
wh2_main_special_settlement_khemri_hef	wh2_main_bas_hef
wh2_main_special_settlement_kislev_hef	wh2_main_bas_hef
wh2_main_special_settlement_lahmia_hef	wh2_main_bas_hef
wh2_main_special_settlement_lothern	wh2_main_bas_hef
wh2_main_special_settlement_miragliano_hef	wh2_main_bas_hef
wh2_main_special_settlement_naggarond_hef	wh2_main_bas_hef
wh2_main_special_settlement_skavenblight_other	wh2_main_bas_hef
wh2_main_special_shrine_of_asuryan_hef	wh2_main_bas_hef
wh2_main_special_shrine_of_khaine_hef	wh2_main_bas_hef
wh2_main_special_tiranoc_palace	wh2_main_bas_hef
wh2_main_special_tor_achare_lions	wh2_main_bas_hef
wh2_main_special_tower_of_hoeth	wh2_main_bas_hef
wh2_main_special_yvresse_amphitheatre	wh2_main_bas_hef
wh2_main_special_ziggurat_of_dawn_beacon	wh2_main_bas_hef
wh2_main_wef_oak_of_ages_occupied	wh2_main_bas_hef
wh_main_bretonnia_legendary_bordeleaux	wh2_main_bas_hef
wh_main_special_bordeleaux_vineyards	wh2_main_bas_hef
wh_main_special_erengrad_port	wh2_main_bas_hef
wh_main_special_marienburg_port	wh2_main_bas_hef
wh2_main_lzd_beasts	wh2_main_bas_lzd
wh2_main_lzd_coldones	wh2_main_bas_lzd
wh2_main_lzd_defence_major	wh2_main_bas_lzd
wh2_main_lzd_defence_minor	wh2_main_bas_lzd
wh2_main_lzd_defence_norsca	wh2_main_bas_lzd
wh2_main_lzd_energy	wh2_main_bas_lzd
wh2_main_lzd_energy_minor	wh2_main_bas_lzd
wh2_main_lzd_farm	wh2_main_bas_lzd
wh2_main_lzd_industry	wh2_main_bas_lzd
wh2_main_lzd_order	wh2_main_bas_lzd
wh2_main_lzd_outpostnorsca_major	wh2_main_bas_lzd
wh2_main_lzd_outpostnorsca_major_coast	wh2_main_bas_lzd
wh2_main_lzd_outpostnorsca_minor	wh2_main_bas_lzd
wh2_main_lzd_outpostnorsca_minor_coast	wh2_main_bas_lzd
wh2_main_lzd_port	wh2_main_bas_lzd
wh2_main_lzd_resource_animals	wh2_main_bas_lzd
wh2_main_lzd_resource_dyes	wh2_main_bas_lzd
wh2_main_lzd_resource_furs	wh2_main_bas_lzd
wh2_main_lzd_resource_gems	wh2_main_bas_lzd
wh2_main_lzd_resource_gold	wh2_main_bas_lzd
wh2_main_lzd_resource_iron	wh2_main_bas_lzd
wh2_main_lzd_resource_marble	wh2_main_bas_lzd
wh2_main_lzd_resource_medicine	wh2_main_bas_lzd
wh2_main_lzd_resource_obsidian	wh2_main_bas_lzd
wh2_main_lzd_resource_pasture	wh2_main_bas_lzd
wh2_main_lzd_resource_pottery	wh2_main_bas_lzd
wh2_main_lzd_resource_salt	wh2_main_bas_lzd
wh2_main_lzd_resource_spices	wh2_main_bas_lzd
wh2_main_lzd_resource_wine	wh2_main_bas_lzd
wh2_main_lzd_resource_wood	wh2_main_bas_lzd
wh2_main_lzd_saurus	wh2_main_bas_lzd
wh2_main_lzd_scrying	wh2_main_bas_lzd
wh2_main_lzd_settlement_major	wh2_main_bas_lzd
wh2_main_lzd_settlement_major_coast	wh2_main_bas_lzd
wh2_main_lzd_settlement_minor	wh2_main_bas_lzd
wh2_main_lzd_settlement_minor_coast	wh2_main_bas_lzd
wh2_main_lzd_skinks	wh2_main_bas_lzd
wh2_main_lzd_slann	wh2_main_bas_lzd
wh2_main_lzd_smith	wh2_main_bas_lzd
wh2_main_lzd_terradons	wh2_main_bas_lzd
wh2_main_lzd_worship_oldones	wh2_main_bas_lzd
wh2_main_lzd_worship_sotek	wh2_main_bas_lzd
wh2_main_ritual_lzd	wh2_main_bas_lzd
wh2_main_special_axlotl_chameleon_shrine	wh2_main_bas_lzd
wh2_main_special_chamber_of_visions	wh2_main_bas_lzd
wh2_main_special_clar_karond_lairs_other	wh2_main_bas_lzd
wh2_main_special_fallen_gates	wh2_main_bas_lzd
wh2_main_special_fortress_gate_eagle_untainted	wh2_main_bas_lzd
wh2_main_special_fortress_gate_griffon_untainted	wh2_main_bas_lzd
wh2_main_special_fortress_gate_phoenix_untainted	wh2_main_bas_lzd
wh2_main_special_fortress_gate_unicorn_untainted	wh2_main_bas_lzd
wh2_main_special_ghrond_convent_of_sorcery_other	wh2_main_bas_lzd
wh2_main_special_golden_tower_of_the_gods_lzd	wh2_main_bas_lzd
wh2_main_special_hag_graef_mines	wh2_main_bas_lzd
wh2_main_special_hexoatl_incubator	wh2_main_bas_lzd
wh2_main_special_hexoatl_stellar_pyramids	wh2_main_bas_lzd
wh2_main_special_itza_emerald_pools	wh2_main_bas_lzd
wh2_main_special_itza_vaults_of_the_old_ones	wh2_main_bas_lzd
wh2_main_special_lothern_port_other	wh2_main_bas_lzd
wh2_main_special_oyxl_shrine_of_birds	wh2_main_bas_lzd
wh2_main_special_pyramid_of_nagash_other	wh2_main_bas_lzd
wh2_main_special_quetza_serpent_lairs	wh2_main_bas_lzd
wh2_main_special_quintex	wh2_main_bas_lzd
wh2_main_special_settlement_altdorf_lzd	wh2_main_bas_lzd
wh2_main_special_settlement_athel_loren_lzd	wh2_main_bas_lzd
wh2_main_special_settlement_black_crag_lzd	wh2_main_bas_lzd
wh2_main_special_settlement_castle_drakenhof_lzd	wh2_main_bas_lzd
wh2_main_special_settlement_colony_major_other	wh2_main_bas_lzd
wh2_main_special_settlement_colony_minor_other	wh2_main_bas_lzd
wh2_main_special_settlement_couronne_lzd	wh2_main_bas_lzd
wh2_main_special_settlement_eight_peaks_lzd	wh2_main_bas_lzd
wh2_main_special_settlement_hellpit_other	wh2_main_bas_lzd
wh2_main_special_settlement_hexoatl_hexoatl	wh2_main_bas_lzd
wh2_main_special_settlement_hexoatl_other_lzd	wh2_main_bas_lzd
wh2_main_special_settlement_itza_itza	wh2_main_bas_lzd
wh2_main_special_settlement_itza_other_lzd	wh2_main_bas_lzd
wh2_main_special_settlement_karaz_a_karak_lzd	wh2_main_bas_lzd
wh2_main_special_settlement_khemri_lzd	wh2_main_bas_lzd
wh2_main_special_settlement_kislev_lzd	wh2_main_bas_lzd
wh2_main_special_settlement_lahmia_lzd	wh2_main_bas_lzd
wh2_main_special_settlement_lothern_lzd	wh2_main_bas_lzd
wh2_main_special_settlement_miragliano_lzd	wh2_main_bas_lzd
wh2_main_special_settlement_naggarond_lzd	wh2_main_bas_lzd
wh2_main_special_settlement_skavenblight_other	wh2_main_bas_lzd
wh2_main_special_shrine_of_asuryan_other	wh2_main_bas_lzd
wh2_main_special_shrine_of_khaine_other	wh2_main_bas_lzd
wh2_main_special_tlaxtlan_temple_of_the_eclipse	wh2_main_bas_lzd
wh2_main_special_tower_of_hoeth_other	wh2_main_bas_lzd
wh2_main_special_xlanhuapec_temple_of_mists	wh2_main_bas_lzd
wh2_main_special_ziggurat_of_dawn_beacon	wh2_main_bas_lzd
wh2_main_wef_oak_of_ages_occupied	wh2_main_bas_lzd
wh_main_bretonnia_legendary_bordeleaux	wh2_main_bas_lzd
wh_main_special_bordeleaux_vineyards	wh2_main_bas_lzd
wh_main_special_erengrad_port	wh2_main_bas_lzd
wh_main_special_marienburg_port	wh2_main_bas_lzd
wh2_main_HUMAN_resource_gemstones	wh2_main_bas_rogue
wh2_main_emp_resource_animals	wh2_main_bas_rogue
wh2_main_emp_resource_medicine	wh2_main_bas_rogue
wh2_main_emp_resource_obsidian	wh2_main_bas_rogue
wh2_main_emp_resource_spices	wh2_main_bas_rogue
wh2_main_horde_rogue_settlement	wh2_main_bas_rogue
wh2_main_rogue_outpostnorsca_major	wh2_main_bas_rogue
wh2_main_rogue_outpostnorsca_major_coast	wh2_main_bas_rogue
wh2_main_rogue_outpostnorsca_minor	wh2_main_bas_rogue
wh2_main_rogue_outpostnorsca_minor_coast	wh2_main_bas_rogue
wh2_main_rogue_settlement_major	wh2_main_bas_rogue
wh2_main_rogue_settlement_major_coast	wh2_main_bas_rogue
wh2_main_rogue_settlement_minor	wh2_main_bas_rogue
wh2_main_rogue_settlement_minor_coast	wh2_main_bas_rogue
wh2_main_special_pyramid_of_nagash_other	wh2_main_bas_rogue
wh2_main_special_settlement_altdorf_other	wh2_main_bas_rogue
wh2_main_special_settlement_athel_loren_rogue	wh2_main_bas_rogue
wh2_main_special_settlement_black_crag_other	wh2_main_bas_rogue
wh2_main_special_settlement_castle_drakenhof_other	wh2_main_bas_rogue
wh2_main_special_settlement_colony_major_other	wh2_main_bas_rogue
wh2_main_special_settlement_colony_minor_other	wh2_main_bas_rogue
wh2_main_special_settlement_couronne_other	wh2_main_bas_rogue
wh2_main_special_settlement_eight_peaks_other	wh2_main_bas_rogue
wh2_main_special_settlement_hellpit_other	wh2_main_bas_rogue
wh2_main_special_settlement_hexoatl_other	wh2_main_bas_rogue
wh2_main_special_settlement_itza_other	wh2_main_bas_rogue
wh2_main_special_settlement_karaz_a_karak_other	wh2_main_bas_rogue
wh2_main_special_settlement_khemri_other	wh2_main_bas_rogue
wh2_main_special_settlement_kislev_other	wh2_main_bas_rogue
wh2_main_special_settlement_lahmia_other	wh2_main_bas_rogue
wh2_main_special_settlement_lothern_other	wh2_main_bas_rogue
wh2_main_special_settlement_miragliano_other	wh2_main_bas_rogue
wh2_main_special_settlement_naggarond_other	wh2_main_bas_rogue
wh2_main_special_settlement_skavenblight_other	wh2_main_bas_rogue
wh2_main_wef_oak_of_ages_occupied	wh2_main_bas_rogue
wh_main_HUMAN_resource_dyes	wh2_main_bas_rogue
wh_main_HUMAN_resource_furs	wh2_main_bas_rogue
wh_main_HUMAN_resource_gold	wh2_main_bas_rogue
wh_main_HUMAN_resource_iron	wh2_main_bas_rogue
wh_main_HUMAN_resource_marble	wh2_main_bas_rogue
wh_main_HUMAN_resource_pastures	wh2_main_bas_rogue
wh_main_HUMAN_resource_pottery	wh2_main_bas_rogue
wh_main_HUMAN_resource_salt	wh2_main_bas_rogue
wh_main_HUMAN_resource_timber	wh2_main_bas_rogue
wh_main_HUMAN_resource_wine	wh2_main_bas_rogue
wh2_main_horde_skaven_assassins	wh2_main_bas_skv
wh2_main_horde_skaven_leadership	wh2_main_bas_skv
wh2_main_horde_skaven_monsters	wh2_main_bas_skv
wh2_main_horde_skaven_plagues	wh2_main_bas_skv
wh2_main_horde_skaven_settlement	wh2_main_bas_skv
wh2_main_horde_skaven_slaves	wh2_main_bas_skv
wh2_main_horde_skaven_stormvermin	wh2_main_bas_skv
wh2_main_horde_skaven_supplies	wh2_main_bas_skv
wh2_main_horde_skaven_warmachines	wh2_main_bas_skv
wh2_main_horde_skaven_weaponteams	wh2_main_bas_skv
wh2_main_ritual_skv	wh2_main_bas_skv
wh2_main_skv_assassins	wh2_main_bas_skv
wh2_main_skv_clanrats	wh2_main_bas_skv
wh2_main_skv_defence_major	wh2_main_bas_skv
wh2_main_skv_defence_minor	wh2_main_bas_skv
wh2_main_skv_defence_norsca	wh2_main_bas_skv
wh2_main_skv_energy	wh2_main_bas_skv
wh2_main_skv_engineers	wh2_main_bas_skv
wh2_main_skv_farm	wh2_main_bas_skv
wh2_main_skv_industry	wh2_main_bas_skv
wh2_main_skv_monsters	wh2_main_bas_skv
wh2_main_skv_order	wh2_main_bas_skv
wh2_main_skv_outpostnorsca_major	wh2_main_bas_skv
wh2_main_skv_outpostnorsca_major_coast	wh2_main_bas_skv
wh2_main_skv_outpostnorsca_minor	wh2_main_bas_skv
wh2_main_skv_outpostnorsca_minor_coast	wh2_main_bas_skv
wh2_main_skv_plagues	wh2_main_bas_skv
wh2_main_skv_port	wh2_main_bas_skv
wh2_main_skv_resource_animals	wh2_main_bas_skv
wh2_main_skv_resource_dyes	wh2_main_bas_skv
wh2_main_skv_resource_furs	wh2_main_bas_skv
wh2_main_skv_resource_gems	wh2_main_bas_skv
wh2_main_skv_resource_gold	wh2_main_bas_skv
wh2_main_skv_resource_iron	wh2_main_bas_skv
wh2_main_skv_resource_marble	wh2_main_bas_skv
wh2_main_skv_resource_medicine	wh2_main_bas_skv
wh2_main_skv_resource_obsidian	wh2_main_bas_skv
wh2_main_skv_resource_pasture	wh2_main_bas_skv
wh2_main_skv_resource_pottery	wh2_main_bas_skv
wh2_main_skv_resource_salt	wh2_main_bas_skv
wh2_main_skv_resource_spices	wh2_main_bas_skv
wh2_main_skv_resource_wine	wh2_main_bas_skv
wh2_main_skv_resource_wood	wh2_main_bas_skv
wh2_main_skv_settlement_major	wh2_main_bas_skv
wh2_main_skv_settlement_major_coast	wh2_main_bas_skv
wh2_main_skv_settlement_minor	wh2_main_bas_skv
wh2_main_skv_settlement_minor_coast	wh2_main_bas_skv
wh2_main_skv_weaponteams	wh2_main_bas_skv
wh2_main_special_chamber_of_visions	wh2_main_bas_skv
wh2_main_special_clar_karond_lairs_skv	wh2_main_bas_skv
wh2_main_special_corrupted_spawning_pool	wh2_main_bas_skv
wh2_main_special_eight_peaks_skv	wh2_main_bas_skv
wh2_main_special_fortress_gate_eagle_skaven	wh2_main_bas_skv
wh2_main_special_fortress_gate_griffon_skaven	wh2_main_bas_skv
wh2_main_special_fortress_gate_phoenix_skaven	wh2_main_bas_skv
wh2_main_special_fortress_gate_unicorn_skaven	wh2_main_bas_skv
wh2_main_special_ghrond_convent_of_sorcery_other	wh2_main_bas_skv
wh2_main_special_golden_tower_of_the_gods_other	wh2_main_bas_skv
wh2_main_special_hag_graef_mines	wh2_main_bas_skv
wh2_main_special_hellpit_pits	wh2_main_bas_skv
wh2_main_special_hexoatl_stellar_pyramids_other	wh2_main_bas_skv
wh2_main_special_itza_emerald_pools	wh2_main_bas_skv
wh2_main_special_lothern_port_other	wh2_main_bas_skv
wh2_main_special_mors_hq	wh2_main_bas_skv
wh2_main_special_pyramid_of_nagash_other	wh2_main_bas_skv
wh2_main_special_quintex	wh2_main_bas_skv
wh2_main_special_settlement_altdorf_skv	wh2_main_bas_skv
wh2_main_special_settlement_athel_loren_skv	wh2_main_bas_skv
wh2_main_special_settlement_black_crag_skv	wh2_main_bas_skv
wh2_main_special_settlement_castle_drakenhof_skv	wh2_main_bas_skv
wh2_main_special_settlement_colony_major_other	wh2_main_bas_skv
wh2_main_special_settlement_colony_minor_other	wh2_main_bas_skv
wh2_main_special_settlement_couronne_skv	wh2_main_bas_skv
wh2_main_special_settlement_eight_peaks_skv	wh2_main_bas_skv
wh2_main_special_settlement_hellpit	wh2_main_bas_skv
wh2_main_special_settlement_hexoatl_skv	wh2_main_bas_skv
wh2_main_special_settlement_itza_skv	wh2_main_bas_skv
wh2_main_special_settlement_karaz_a_karak_skv	wh2_main_bas_skv
wh2_main_special_settlement_khemri_skv	wh2_main_bas_skv
wh2_main_special_settlement_kislev_skv	wh2_main_bas_skv
wh2_main_special_settlement_lahmia_skv	wh2_main_bas_skv
wh2_main_special_settlement_lothern_skv	wh2_main_bas_skv
wh2_main_special_settlement_miragliano_skv	wh2_main_bas_skv
wh2_main_special_settlement_naggarond_skv	wh2_main_bas_skv
wh2_main_special_settlement_skavenblight	wh2_main_bas_skv
wh2_main_special_shrine_of_asuryan_other	wh2_main_bas_skv
wh2_main_special_shrine_of_khaine_other	wh2_main_bas_skv
wh2_main_special_skavenblight_council13	wh2_main_bas_skv
wh2_main_special_skavenblight_shattered_tower	wh2_main_bas_skv
wh2_main_special_tower_of_hoeth_other	wh2_main_bas_skv
wh2_main_special_underway_hub_skv	wh2_main_bas_skv
wh2_main_special_ziggurat_of_dawn_beacon_skv	wh2_main_bas_skv
wh2_main_wef_oak_of_ages_occupied	wh2_main_bas_skv
wh_main_bretonnia_legendary_bordeleaux	wh2_main_bas_skv
wh_main_special_bordeleaux_vineyards	wh2_main_bas_skv
wh_main_special_erengrad_port	wh2_main_bas_skv
wh_main_special_marienburg_port	wh2_main_bas_skv
wh_dlc03_BEASTMEN_port	wh_dlc03_bas_bst
wh_dlc03_horde_beastmen_arcane	wh_dlc03_bas_bst
wh_dlc03_horde_beastmen_centigors	wh_dlc03_bas_bst
wh_dlc03_horde_beastmen_creatures	wh_dlc03_bas_bst
wh_dlc03_horde_beastmen_giants	wh_dlc03_bas_bst
wh_dlc03_horde_beastmen_gors	wh_dlc03_bas_bst
wh_dlc03_horde_beastmen_herd	wh_dlc03_bas_bst
wh_dlc03_horde_beastmen_minotaurs	wh_dlc03_bas_bst
wh_dlc03_horde_beastmen_razorgors	wh_dlc03_bas_bst
wh_dlc03_horde_beastmen_ruination	wh_dlc03_bas_bst
wh_dlc03_horde_beastmen_weapons	wh_dlc03_bas_bst
wh2_main_special_everqueen_court_wef	wh_dlc05_bas_wef
wh2_main_special_fortress_gate_eagle_wef	wh_dlc05_bas_wef
wh2_main_special_fortress_gate_griffon_wef	wh_dlc05_bas_wef
wh2_main_special_fortress_gate_phoenix_wef	wh_dlc05_bas_wef
wh2_main_special_fortress_gate_unicorn_wef	wh_dlc05_bas_wef
wh2_main_special_hag_graef_mines	wh_dlc05_bas_wef
wh2_main_special_lothern_port_other	wh_dlc05_bas_wef
wh2_main_special_settlement_colony_major_wef	wh_dlc05_bas_wef
wh2_main_special_settlement_colony_minor_wef	wh_dlc05_bas_wef
wh2_main_special_settlement_hellpit_wef	wh_dlc05_bas_wef
wh2_main_special_settlement_hexoatl_wef	wh_dlc05_bas_wef
wh2_main_special_settlement_itza_wef	wh_dlc05_bas_wef
wh2_main_special_settlement_khemri_wef	wh_dlc05_bas_wef
wh2_main_special_settlement_lahmia_wef	wh_dlc05_bas_wef
wh2_main_special_settlement_lothern_wef	wh_dlc05_bas_wef
wh2_main_special_settlement_naggarond_wef	wh_dlc05_bas_wef
wh2_main_special_settlement_skavenblight_wef	wh_dlc05_bas_wef
wh2_main_special_shrine_of_asuryan_other	wh_dlc05_bas_wef
wh2_main_special_shrine_of_khaine_other	wh_dlc05_bas_wef
wh2_main_wef_eco_court	wh_dlc05_bas_wef
wh2_main_wef_replenishment	wh_dlc05_bas_wef
wh2_main_wef_resource_animals	wh_dlc05_bas_wef
wh2_main_wef_resource_gems	wh_dlc05_bas_wef
wh2_main_wef_resource_medicine	wh_dlc05_bas_wef
wh2_main_wef_resource_obsidian	wh_dlc05_bas_wef
wh2_main_wef_resource_spices	wh_dlc05_bas_wef
wh_dlc05_special_bordeleaux_port_wef	wh_dlc05_bas_wef
wh_dlc05_special_city_altdorf_woodelves	wh_dlc05_bas_wef
wh_dlc05_special_city_black_crag_woodelves	wh_dlc05_bas_wef
wh_dlc05_special_city_castle_drakenhof_woodelves	wh_dlc05_bas_wef
wh_dlc05_special_city_couronne_woodelves	wh_dlc05_bas_wef
wh_dlc05_special_city_eight_peaks_woodelves	wh_dlc05_bas_wef
wh_dlc05_special_city_karaz_a_karak_woodelves	wh_dlc05_bas_wef
wh_dlc05_special_city_kislev_woodelves	wh_dlc05_bas_wef
wh_dlc05_special_city_miragliano_woodelves	wh_dlc05_bas_wef
wh_dlc05_special_erengrad_port_wef	wh_dlc05_bas_wef
wh_dlc05_special_marienburg_port_wef	wh_dlc05_bas_wef
wh_dlc05_wef_agent_protection	wh_dlc05_bas_wef
wh_dlc05_wef_armoury	wh_dlc05_bas_wef
wh_dlc05_wef_cavalry	wh_dlc05_bas_wef
wh_dlc05_wef_dragons	wh_dlc05_bas_wef
wh_dlc05_wef_fletcher	wh_dlc05_bas_wef
wh_dlc05_wef_flying	wh_dlc05_bas_wef
wh_dlc05_wef_garrison	wh_dlc05_bas_wef
wh_dlc05_wef_growth	wh_dlc05_bas_wef
wh_dlc05_wef_income	wh_dlc05_bas_wef
wh_dlc05_wef_income_buff	wh_dlc05_bas_wef
wh_dlc05_wef_melee	wh_dlc05_bas_wef
wh_dlc05_wef_oak_of_ages	wh_dlc05_bas_wef
wh_dlc05_wef_oak_of_ages_mini	wh_dlc05_bas_wef
wh_dlc05_wef_office_starlight_forge	wh_dlc05_bas_wef
wh_dlc05_wef_office_the_wild_heath	wh_dlc05_bas_wef
wh_dlc05_wef_office_wardancer_feast_halls	wh_dlc05_bas_wef
wh_dlc05_wef_office_wildwood_waystones	wh_dlc05_bas_wef
wh_dlc05_wef_outpost_foraging	wh_dlc05_bas_wef
wh_dlc05_wef_outpost_major_dwarfhold	wh_dlc05_bas_wef
wh_dlc05_wef_outpost_major_dwarfhold_coast	wh_dlc05_bas_wef
wh_dlc05_wef_outpost_major_human	wh_dlc05_bas_wef
wh_dlc05_wef_outpost_major_human_coast	wh_dlc05_bas_wef
wh_dlc05_wef_outpost_minor_dwarfhold	wh_dlc05_bas_wef
wh_dlc05_wef_outpost_minor_dwarfhold_coast	wh_dlc05_bas_wef
wh_dlc05_wef_outpost_minor_human	wh_dlc05_bas_wef
wh_dlc05_wef_outpost_minor_human_coast	wh_dlc05_bas_wef
wh_dlc05_wef_outpost_norsca_major	wh_dlc05_bas_wef
wh_dlc05_wef_outpost_norsca_major_coast	wh_dlc05_bas_wef
wh_dlc05_wef_outpost_norsca_minor	wh_dlc05_bas_wef
wh_dlc05_wef_outpost_norsca_minor_coast	wh_dlc05_bas_wef
wh_dlc05_wef_outpost_recruitment	wh_dlc05_bas_wef
wh_dlc05_wef_outpost_replenishment	wh_dlc05_bas_wef
wh_dlc05_wef_outpost_slaughter	wh_dlc05_bas_wef
wh_dlc05_wef_port	wh_dlc05_bas_wef
wh_dlc05_wef_public_order	wh_dlc05_bas_wef
wh_dlc05_wef_ranged	wh_dlc05_bas_wef
wh_dlc05_wef_resource_dyes	wh_dlc05_bas_wef
wh_dlc05_wef_resource_furs	wh_dlc05_bas_wef
wh_dlc05_wef_resource_gold	wh_dlc05_bas_wef
wh_dlc05_wef_resource_iron	wh_dlc05_bas_wef
wh_dlc05_wef_resource_marble	wh_dlc05_bas_wef
wh_dlc05_wef_resource_pastures	wh_dlc05_bas_wef
wh_dlc05_wef_resource_pottery	wh_dlc05_bas_wef
wh_dlc05_wef_resource_salt	wh_dlc05_bas_wef
wh_dlc05_wef_resource_timber	wh_dlc05_bas_wef
wh_dlc05_wef_resource_wine	wh_dlc05_bas_wef
wh_dlc05_wef_settlement_major	wh_dlc05_bas_wef
wh_dlc05_wef_settlement_major_coast	wh_dlc05_bas_wef
wh_dlc05_wef_settlement_major_main	wh_dlc05_bas_wef
wh_dlc05_wef_settlement_minor	wh_dlc05_bas_wef
wh_dlc05_wef_settlement_minor_coast	wh_dlc05_bas_wef
wh_dlc05_wef_spellsingers	wh_dlc05_bas_wef
wh_dlc05_wef_temple_anath_raema	wh_dlc05_bas_wef
wh_dlc05_wef_temple_ereth_khial	wh_dlc05_bas_wef
wh_dlc05_wef_temple_isha	wh_dlc05_bas_wef
wh_dlc05_wef_temple_kurnous	wh_dlc05_bas_wef
wh_dlc05_wef_tree_delliandra	wh_dlc05_bas_wef
wh_dlc05_wef_tree_druthandor	wh_dlc05_bas_wef
wh_dlc05_wef_tree_spirits	wh_dlc05_bas_wef
wh_dlc05_wef_tree_talrennic	wh_dlc05_bas_wef
wh_dlc05_wef_tree_threllock	wh_dlc05_bas_wef
wh_dlc05_wef_walls	wh_dlc05_bas_wef
wh2_main_brt_defence_norsca	wh_main_bas_brt
wh2_main_brt_resource_animals	wh_main_bas_brt
wh2_main_brt_resource_dyes	wh_main_bas_brt
wh2_main_brt_resource_furs	wh_main_bas_brt
wh2_main_brt_resource_gemstones	wh_main_bas_brt
wh2_main_brt_resource_gold	wh_main_bas_brt
wh2_main_brt_resource_iron	wh_main_bas_brt
wh2_main_brt_resource_marble	wh_main_bas_brt
wh2_main_brt_resource_medicine	wh_main_bas_brt
wh2_main_brt_resource_obsidian	wh_main_bas_brt
wh2_main_brt_resource_pastures	wh_main_bas_brt
wh2_main_brt_resource_pottery	wh_main_bas_brt
wh2_main_brt_resource_salt	wh_main_bas_brt
wh2_main_brt_resource_spices	wh_main_bas_brt
wh2_main_brt_resource_timber	wh_main_bas_brt
wh2_main_brt_resource_wine	wh_main_bas_brt
wh2_main_special_altdorf_imperial_palace_brt	wh_main_bas_brt
wh2_main_special_chamber_of_visions	wh_main_bas_brt
wh2_main_special_clar_karond_lairs_other	wh_main_bas_brt
wh2_main_special_fortress_gate_eagle_untainted	wh_main_bas_brt
wh2_main_special_fortress_gate_griffon_untainted	wh_main_bas_brt
wh2_main_special_fortress_gate_phoenix_untainted	wh_main_bas_brt
wh2_main_special_fortress_gate_unicorn_untainted	wh_main_bas_brt
wh2_main_special_ghrond_convent_of_sorcery_other	wh_main_bas_brt
wh2_main_special_glittering_tower	wh_main_bas_brt
wh2_main_special_golden_tower_of_the_gods_other	wh_main_bas_brt
wh2_main_special_hag_graef_mines	wh_main_bas_brt
wh2_main_special_hexoatl_stellar_pyramids_other	wh_main_bas_brt
wh2_main_special_itza_emerald_pools	wh_main_bas_brt
wh2_main_special_lothern_port_other	wh_main_bas_brt
wh2_main_special_pyramid_of_nagash_other	wh_main_bas_brt
wh2_main_special_quintex	wh_main_bas_brt
wh2_main_special_settlement_athel_loren_brt	wh_main_bas_brt
wh2_main_special_settlement_black_crag_brt	wh_main_bas_brt
wh2_main_special_settlement_colony_major_other	wh_main_bas_brt
wh2_main_special_settlement_colony_minor_other	wh_main_bas_brt
wh2_main_special_settlement_eight_peaks_brt	wh_main_bas_brt
wh2_main_special_settlement_hellpit_other	wh_main_bas_brt
wh2_main_special_settlement_hexoatl_brt	wh_main_bas_brt
wh2_main_special_settlement_itza_brt	wh_main_bas_brt
wh2_main_special_settlement_karaz_a_karak_brt	wh_main_bas_brt
wh2_main_special_settlement_khemri_brt	wh_main_bas_brt
wh2_main_special_settlement_lahmia_brt	wh_main_bas_brt
wh2_main_special_settlement_lothern_brt	wh_main_bas_brt
wh2_main_special_settlement_naggarond_brt	wh_main_bas_brt
wh2_main_special_settlement_skavenblight_other	wh_main_bas_brt
wh2_main_special_shrine_of_asuryan_other	wh_main_bas_brt
wh2_main_special_shrine_of_khaine_other	wh_main_bas_brt
wh2_main_special_tower_of_hoeth_other	wh_main_bas_brt
wh2_main_special_ziggurat_of_dawn_beacon	wh_main_bas_brt
wh2_main_wef_oak_of_ages_occupied	wh_main_bas_brt
wh_main_BRETONNIA_barracks	wh_main_bas_brt
wh_main_BRETONNIA_carpenter	wh_main_bas_brt
wh_main_BRETONNIA_farm_basic	wh_main_bas_brt
wh_main_BRETONNIA_farm_extra	wh_main_bas_brt
wh_main_BRETONNIA_garrison	wh_main_bas_brt
wh_main_BRETONNIA_hospital	wh_main_bas_brt
wh_main_BRETONNIA_industry_basic	wh_main_bas_brt
wh_main_BRETONNIA_industry_extra	wh_main_bas_brt
wh_main_BRETONNIA_outpostnorsca_major	wh_main_bas_brt
wh_main_BRETONNIA_outpostnorsca_major_coast	wh_main_bas_brt
wh_main_BRETONNIA_outpostnorsca_minor	wh_main_bas_brt
wh_main_BRETONNIA_outpostnorsca_minor_coast	wh_main_bas_brt
wh_main_BRETONNIA_port	wh_main_bas_brt
wh_main_BRETONNIA_settlement_major	wh_main_bas_brt
wh_main_BRETONNIA_settlement_major_coast	wh_main_bas_brt
wh_main_BRETONNIA_settlement_minor	wh_main_bas_brt
wh_main_BRETONNIA_settlement_minor_coast	wh_main_bas_brt
wh_main_BRETONNIA_smith	wh_main_bas_brt
wh_main_BRETONNIA_stables	wh_main_bas_brt
wh_main_BRETONNIA_tavern	wh_main_bas_brt
wh_main_BRETONNIA_walls	wh_main_bas_brt
wh_main_BRETONNIA_worship	wh_main_bas_brt
wh_main_bretonnia_legendary_bordeleaux	wh_main_bas_brt
wh_main_bretonnia_legendary_bretonnia	wh_main_bas_brt
wh_main_bretonnia_legendary_carcassonne	wh_main_bas_brt
wh_main_special_bokha_palace	wh_main_bas_brt
wh_main_special_bordeleaux_vineyards	wh_main_bas_brt
wh_main_special_erengrad_port	wh_main_bas_brt
wh_main_special_marienburg_port	wh_main_bas_brt
wh_main_special_settlement_altdorf_bretonnia	wh_main_bas_brt
wh_main_special_settlement_castle_drakenhof_bretonnia	wh_main_bas_brt
wh_main_special_settlement_couronne	wh_main_bas_brt
wh_main_special_settlement_kislev_bretonnia	wh_main_bas_brt
wh_main_special_settlement_miragliano_bretonnia	wh_main_bas_brt
wh_main_special_tournament_grounds	wh_main_bas_brt
wh_main_CHAOS_port	wh_main_bas_chs
wh_main_horde_chaos_dragon_ogres	wh_main_bas_chs
wh_main_horde_chaos_forge	wh_main_bas_chs
wh_main_horde_chaos_giants	wh_main_bas_chs
wh_main_horde_chaos_knights	wh_main_bas_chs
wh_main_horde_chaos_magic	wh_main_bas_chs
wh_main_horde_chaos_marauders	wh_main_bas_chs
wh_main_horde_chaos_settlement	wh_main_bas_chs
wh_main_horde_chaos_trolls	wh_main_bas_chs
wh_main_horde_chaos_warriors	wh_main_bas_chs
wh_main_horde_chaos_weapons	wh_main_bas_chs
wh2_main_DWARFS_resource_pottery	wh_main_bas_dwf
wh2_main_DWARFS_resource_wine	wh_main_bas_dwf
wh2_main_dwf_defence_norsca	wh_main_bas_dwf
wh2_main_dwf_resource_animals	wh_main_bas_dwf
wh2_main_dwf_resource_medicine	wh_main_bas_dwf
wh2_main_dwf_resource_obsidian	wh_main_bas_dwf
wh2_main_dwf_resource_spices	wh_main_bas_dwf
wh2_main_special_brewery	wh_main_bas_dwf
wh2_main_special_chamber_of_visions	wh_main_bas_dwf
wh2_main_special_clar_karond_lairs_other	wh_main_bas_dwf
wh2_main_special_fortress_gate_eagle_untainted	wh_main_bas_dwf
wh2_main_special_fortress_gate_griffon_untainted	wh_main_bas_dwf
wh2_main_special_fortress_gate_phoenix_untainted	wh_main_bas_dwf
wh2_main_special_fortress_gate_unicorn_untainted	wh_main_bas_dwf
wh2_main_special_ghrond_convent_of_sorcery_other	wh_main_bas_dwf
wh2_main_special_golden_tower_of_the_gods_other	wh_main_bas_dwf
wh2_main_special_hag_graef_mines	wh_main_bas_dwf
wh2_main_special_hexoatl_stellar_pyramids_other	wh_main_bas_dwf
wh2_main_special_itza_emerald_pools	wh_main_bas_dwf
wh2_main_special_karaz_a_karak_airport	wh_main_bas_dwf
wh2_main_special_lothern_port_other	wh_main_bas_dwf
wh2_main_special_pyramid_of_nagash_other	wh_main_bas_dwf
wh2_main_special_quintex	wh_main_bas_dwf
wh2_main_special_settlement_altdorf_dwf	wh_main_bas_dwf
wh2_main_special_settlement_athel_loren_dwf	wh_main_bas_dwf
wh2_main_special_settlement_castle_drakenhof_dwf	wh_main_bas_dwf
wh2_main_special_settlement_colony_major_other	wh_main_bas_dwf
wh2_main_special_settlement_colony_minor_other	wh_main_bas_dwf
wh2_main_special_settlement_couronne_dwf	wh_main_bas_dwf
wh2_main_special_settlement_hellpit_other	wh_main_bas_dwf
wh2_main_special_settlement_hexoatl_dwf	wh_main_bas_dwf
wh2_main_special_settlement_itza_dwf	wh_main_bas_dwf
wh2_main_special_settlement_khemri_dwf	wh_main_bas_dwf
wh2_main_special_settlement_kislev_dwf	wh_main_bas_dwf
wh2_main_special_settlement_lahmia_dwf	wh_main_bas_dwf
wh2_main_special_settlement_lothern_dwf	wh_main_bas_dwf
wh2_main_special_settlement_miragliano_dwf	wh_main_bas_dwf
wh2_main_special_settlement_naggarond_dwf	wh_main_bas_dwf
wh2_main_special_settlement_skavenblight_other	wh_main_bas_dwf
wh2_main_special_shrine_of_asuryan_other	wh_main_bas_dwf
wh2_main_special_shrine_of_khaine_other	wh_main_bas_dwf
wh2_main_special_tower_of_hoeth_other	wh_main_bas_dwf
wh2_main_special_underway_hub_dwf	wh_main_bas_dwf
wh2_main_special_ziggurat_of_dawn_beacon	wh_main_bas_dwf
wh2_main_wef_oak_of_ages_occupied	wh_main_bas_dwf
wh_dlc06_DWARFS_eight_peaks	wh_main_bas_dwf
wh_dlc06_DWARFS_ranger_hub	wh_main_bas_dwf
wh_dlc06_DWARFS_ranger_hub_all	wh_main_bas_dwf
wh_main_DWARFS_barracks	wh_main_bas_dwf
wh_main_DWARFS_engineer	wh_main_bas_dwf
wh_main_DWARFS_farm	wh_main_bas_dwf
wh_main_DWARFS_garrison	wh_main_bas_dwf
wh_main_DWARFS_industry	wh_main_bas_dwf
wh_main_DWARFS_oaths	wh_main_bas_dwf
wh_main_DWARFS_outpostnorsca_major	wh_main_bas_dwf
wh_main_DWARFS_outpostnorsca_major_coast	wh_main_bas_dwf
wh_main_DWARFS_outpostnorsca_minor	wh_main_bas_dwf
wh_main_DWARFS_outpostnorsca_minor_coast	wh_main_bas_dwf
wh_main_DWARFS_resource_brine	wh_main_bas_dwf
wh_main_DWARFS_resource_cinnabar	wh_main_bas_dwf
wh_main_DWARFS_resource_coal	wh_main_bas_dwf
wh_main_DWARFS_resource_game	wh_main_bas_dwf
wh_main_DWARFS_resource_gemstones	wh_main_bas_dwf
wh_main_DWARFS_resource_gold	wh_main_bas_dwf
wh_main_DWARFS_resource_iron	wh_main_bas_dwf
wh_main_DWARFS_resource_marble	wh_main_bas_dwf
wh_main_DWARFS_resource_pastures	wh_main_bas_dwf
wh_main_DWARFS_resource_water	wh_main_bas_dwf
wh_main_DWARFS_settlement_major	wh_main_bas_dwf
wh_main_DWARFS_settlement_major_coast	wh_main_bas_dwf
wh_main_DWARFS_settlement_minor	wh_main_bas_dwf
wh_main_DWARFS_settlement_minor_coast	wh_main_bas_dwf
wh_main_DWARFS_slayers	wh_main_bas_dwf
wh_main_DWARFS_smiths	wh_main_bas_dwf
wh_main_DWARFS_tavern	wh_main_bas_dwf
wh_main_DWARFS_trade_depot	wh_main_bas_dwf
wh_main_DWARFS_walls	wh_main_bas_dwf
wh_main_DWARFS_workshops	wh_main_bas_dwf
wh_main_DWARF_port	wh_main_bas_dwf
wh_main_bretonnia_legendary_bordeleaux	wh_main_bas_dwf
wh_main_special_bordeleaux_vineyards	wh_main_bas_dwf
wh_main_special_brightstone_mine	wh_main_bas_dwf
wh_main_special_erengrad_port	wh_main_bas_dwf
wh_main_special_great_slayer_shrine	wh_main_bas_dwf
wh_main_special_high_king_throne_hall	wh_main_bas_dwf
wh_main_special_marienburg_port	wh_main_bas_dwf
wh_main_special_settlement_black_crag_dwarf	wh_main_bas_dwf
wh_main_special_settlement_eight_peaks_dwarf	wh_main_bas_dwf
wh_main_special_settlement_karaz_a_karak	wh_main_bas_dwf
wh2_main_EMPIRE_academy	wh_main_bas_emp
wh2_main_EMPIRE_roads	wh_main_bas_emp
wh2_main_HUMAN_resource_gemstones	wh_main_bas_emp
wh2_main_emp_defence_norsca	wh_main_bas_emp
wh2_main_emp_resource_animals	wh_main_bas_emp
wh2_main_emp_resource_medicine	wh_main_bas_emp
wh2_main_emp_resource_obsidian	wh_main_bas_emp
wh2_main_emp_resource_spices	wh_main_bas_emp
wh2_main_special_altdorf_castle_reikguard	wh_main_bas_emp
wh2_main_special_altdorf_imperial_palace	wh_main_bas_emp
wh2_main_special_chamber_of_visions	wh_main_bas_emp
wh2_main_special_clar_karond_lairs_emp	wh_main_bas_emp
wh2_main_special_fortress_gate_eagle_untainted	wh_main_bas_emp
wh2_main_special_fortress_gate_griffon_untainted	wh_main_bas_emp
wh2_main_special_fortress_gate_phoenix_untainted	wh_main_bas_emp
wh2_main_special_fortress_gate_unicorn_untainted	wh_main_bas_emp
wh2_main_special_ghrond_convent_of_sorcery_emp	wh_main_bas_emp
wh2_main_special_glittering_tower	wh_main_bas_emp
wh2_main_special_golden_tower_of_the_gods_other	wh_main_bas_emp
wh2_main_special_hag_graef_mines	wh_main_bas_emp
wh2_main_special_hexoatl_stellar_pyramids_other	wh_main_bas_emp
wh2_main_special_itza_emerald_pools	wh_main_bas_emp
wh2_main_special_lothern_port_other	wh_main_bas_emp
wh2_main_special_pyramid_of_nagash_other	wh_main_bas_emp
wh2_main_special_quintex	wh_main_bas_emp
wh2_main_special_settlement_athel_loren_emp	wh_main_bas_emp
wh2_main_special_settlement_black_crag_emp	wh_main_bas_emp
wh2_main_special_settlement_colony_major_other	wh_main_bas_emp
wh2_main_special_settlement_colony_minor_other	wh_main_bas_emp
wh2_main_special_settlement_eight_peaks_emp	wh_main_bas_emp
wh2_main_special_settlement_hellpit_other	wh_main_bas_emp
wh2_main_special_settlement_hexoatl_emp	wh_main_bas_emp
wh2_main_special_settlement_itza_emp	wh_main_bas_emp
wh2_main_special_settlement_karaz_a_karak_emp	wh_main_bas_emp
wh2_main_special_settlement_khemri_emp	wh_main_bas_emp
wh2_main_special_settlement_lahmia_emp	wh_main_bas_emp
wh2_main_special_settlement_lothern_emp	wh_main_bas_emp
wh2_main_special_settlement_naggarond_emp	wh_main_bas_emp
wh2_main_special_settlement_skavenblight_other	wh_main_bas_emp
wh2_main_special_shrine_of_asuryan_other	wh_main_bas_emp
wh2_main_special_shrine_of_khaine_other	wh_main_bas_emp
wh2_main_special_tower_of_hoeth_emp	wh_main_bas_emp
wh2_main_special_ziggurat_of_dawn_beacon	wh_main_bas_emp
wh2_main_wef_oak_of_ages_occupied	wh_main_bas_emp
wh_main_EMPIRE_barracks	wh_main_bas_emp
wh_main_EMPIRE_farm_basic	wh_main_bas_emp
wh_main_EMPIRE_forges	wh_main_bas_emp
wh_main_EMPIRE_garrison	wh_main_bas_emp
wh_main_EMPIRE_industry_basic	wh_main_bas_emp
wh_main_EMPIRE_outpostnorsca_major	wh_main_bas_emp
wh_main_EMPIRE_outpostnorsca_major_coast	wh_main_bas_emp
wh_main_EMPIRE_outpostnorsca_minor	wh_main_bas_emp
wh_main_EMPIRE_outpostnorsca_minor_coast	wh_main_bas_emp
wh_main_EMPIRE_port	wh_main_bas_emp
wh_main_EMPIRE_settlement_major	wh_main_bas_emp
wh_main_EMPIRE_settlement_major_coast	wh_main_bas_emp
wh_main_EMPIRE_settlement_minor	wh_main_bas_emp
wh_main_EMPIRE_settlement_minor_coast	wh_main_bas_emp
wh_main_EMPIRE_smiths	wh_main_bas_emp
wh_main_EMPIRE_stables	wh_main_bas_emp
wh_main_EMPIRE_tavern	wh_main_bas_emp
wh_main_EMPIRE_walls	wh_main_bas_emp
wh_main_EMPIRE_wizards	wh_main_bas_emp
wh_main_EMPIRE_worship	wh_main_bas_emp
wh_main_HUMAN_MIDDENHEIM_worship	wh_main_bas_emp
wh_main_HUMAN_TALABEC_worship	wh_main_bas_emp
wh_main_HUMAN_resource_dyes	wh_main_bas_emp
wh_main_HUMAN_resource_furs	wh_main_bas_emp
wh_main_HUMAN_resource_gold	wh_main_bas_emp
wh_main_HUMAN_resource_iron	wh_main_bas_emp
wh_main_HUMAN_resource_marble	wh_main_bas_emp
wh_main_HUMAN_resource_pastures	wh_main_bas_emp
wh_main_HUMAN_resource_pottery	wh_main_bas_emp
wh_main_HUMAN_resource_salt	wh_main_bas_emp
wh_main_HUMAN_resource_timber	wh_main_bas_emp
wh_main_HUMAN_resource_wine	wh_main_bas_emp
wh_main_bretonnia_legendary_bordeleaux	wh_main_bas_emp
wh_main_special_archecclesiatium	wh_main_bas_emp
wh_main_special_blazing_sun_chapterhouse	wh_main_bas_emp
wh_main_special_bokha_palace	wh_main_bas_emp
wh_main_special_bordeleaux_vineyards	wh_main_bas_emp
wh_main_special_college_of_magic	wh_main_bas_emp
wh_main_special_erengrad_port	wh_main_bas_emp
wh_main_special_great_temple_of_ulric	wh_main_bas_emp
wh_main_special_knights_panther_chapterhouse	wh_main_bas_emp
wh_main_special_marienburg_port	wh_main_bas_emp
wh_main_special_nuln_gunnery_school	wh_main_bas_emp
wh_main_special_reiksfort	wh_main_bas_emp
wh_main_special_settlement_altdorf	wh_main_bas_emp
wh_main_special_settlement_castle_drakenhof_empire	wh_main_bas_emp
wh_main_special_settlement_couronne_empire	wh_main_bas_emp
wh_main_special_settlement_kislev_empire	wh_main_bas_emp
wh_main_special_settlement_miragliano_empire	wh_main_bas_emp
wh_main_special_tournament_grounds	wh_main_bas_emp
wh2_main_special_big_fort	wh_main_bas_gob
wh2_main_special_dorks_rock	wh_main_bas_gob
wh_dlc06_GREENSKIN_squigs	wh_main_bas_gob
wh_main_GREENSKIN_farm	wh_main_bas_gob
wh_main_GREENSKIN_forest_beasts	wh_main_bas_gob
wh_main_GREENSKIN_garrison	wh_main_bas_gob
wh_main_GREENSKIN_industry	wh_main_bas_gob
wh_main_GREENSKIN_monsters	wh_main_bas_gob
wh_main_GREENSKIN_walls	wh_main_bas_gob
wh_main_GREENSKIN_workshop	wh_main_bas_gob
wh_main_special_savage_orc_camp	wh_main_bas_gob
wh2_main_grn_defence_norsca	wh_main_bas_grn
wh2_main_grn_raiders	wh_main_bas_grn
wh2_main_special_chamber_of_visions	wh_main_bas_grn
wh2_main_special_clar_karond_lairs_grn	wh_main_bas_grn
wh2_main_special_ghrond_convent_of_sorcery_other	wh_main_bas_grn
wh2_main_special_golden_tower_of_the_gods_other	wh_main_bas_grn
wh2_main_special_hag_graef_mines	wh_main_bas_grn
wh2_main_special_hexoatl_stellar_pyramids_other	wh_main_bas_grn
wh2_main_special_itza_emerald_pools	wh_main_bas_grn
wh2_main_special_lothern_port_other	wh_main_bas_grn
wh2_main_special_pyramid_of_nagash_other	wh_main_bas_grn
wh2_main_special_quintex	wh_main_bas_grn
wh2_main_special_settlement_altdorf_grn	wh_main_bas_grn
wh2_main_special_settlement_athel_loren_grn	wh_main_bas_grn
wh2_main_special_settlement_castle_drakenhof_grn	wh_main_bas_grn
wh2_main_special_settlement_colony_major_other	wh_main_bas_grn
wh2_main_special_settlement_colony_minor_other	wh_main_bas_grn
wh2_main_special_settlement_couronne_grn	wh_main_bas_grn
wh2_main_special_settlement_hellpit_other	wh_main_bas_grn
wh2_main_special_settlement_hexoatl_grn	wh_main_bas_grn
wh2_main_special_settlement_itza_grn	wh_main_bas_grn
wh2_main_special_settlement_khemri_grn	wh_main_bas_grn
wh2_main_special_settlement_kislev_grn	wh_main_bas_grn
wh2_main_special_settlement_lahmia_grn	wh_main_bas_grn
wh2_main_special_settlement_lothern_grn	wh_main_bas_grn
wh2_main_special_settlement_miragliano_grn	wh_main_bas_grn
wh2_main_special_settlement_naggarond_grn	wh_main_bas_grn
wh2_main_special_settlement_skavenblight_other	wh_main_bas_grn
wh2_main_special_shrine_of_asuryan_other	wh_main_bas_grn
wh2_main_special_shrine_of_khaine_other	wh_main_bas_grn
wh2_main_special_tower_of_hoeth_other	wh_main_bas_grn
wh2_main_special_troll_lair	wh_main_bas_grn
wh2_main_special_ziggurat_of_dawn_beacon	wh_main_bas_grn
wh_dlc06_GREENSKINS_resource_animals	wh_main_bas_grn
wh_dlc06_GREENSKIN_eight_peaks	wh_main_bas_grn
wh_main_GREENSKINS_resource_gemstones	wh_main_bas_grn
wh_main_GREENSKINS_resource_gold	wh_main_bas_grn
wh_main_GREENSKINS_resource_iron_military	wh_main_bas_grn
wh_main_GREENSKINS_resource_pastures_furs_military	wh_main_bas_grn
wh_main_GREENSKINS_resource_timber_military	wh_main_bas_grn
wh_main_GREENSKIN_port	wh_main_bas_grn
wh_main_bretonnia_legendary_bordeleaux	wh_main_bas_grn
wh_main_special_erengrad_port	wh_main_bas_grn
wh_main_special_marienburg_port	wh_main_bas_grn
wh_main_special_settlement_black_crag	wh_main_bas_grn
wh_main_special_settlement_eight_peaks	wh_main_bas_grn
wh2_main_EMPIRE_academy	wh_main_bas_ksl
wh2_main_EMPIRE_roads	wh_main_bas_ksl
wh2_main_HUMAN_resource_gemstones	wh_main_bas_ksl
wh2_main_emp_defence_norsca	wh_main_bas_ksl
wh2_main_emp_resource_animals	wh_main_bas_ksl
wh2_main_emp_resource_medicine	wh_main_bas_ksl
wh2_main_emp_resource_obsidian	wh_main_bas_ksl
wh2_main_emp_resource_spices	wh_main_bas_ksl
wh2_main_special_altdorf_imperial_palace	wh_main_bas_ksl
wh2_main_special_chamber_of_visions	wh_main_bas_ksl
wh2_main_special_clar_karond_lairs_other	wh_main_bas_ksl
wh2_main_special_ghrond_convent_of_sorcery_emp	wh_main_bas_ksl
wh2_main_special_glittering_tower	wh_main_bas_ksl
wh2_main_special_golden_tower_of_the_gods_other	wh_main_bas_ksl
wh2_main_special_hag_graef_mines	wh_main_bas_ksl
wh2_main_special_hexoatl_stellar_pyramids_other	wh_main_bas_ksl
wh2_main_special_itza_emerald_pools	wh_main_bas_ksl
wh2_main_special_lothern_port_other	wh_main_bas_ksl
wh2_main_special_quintex	wh_main_bas_ksl
wh2_main_special_settlement_athel_loren_emp	wh_main_bas_ksl
wh2_main_special_settlement_black_crag_emp	wh_main_bas_ksl
wh2_main_special_settlement_colony_major_other	wh_main_bas_ksl
wh2_main_special_settlement_colony_minor_other	wh_main_bas_ksl
wh2_main_special_settlement_eight_peaks_emp	wh_main_bas_ksl
wh2_main_special_settlement_hellpit_other	wh_main_bas_ksl
wh2_main_special_settlement_hexoatl_emp	wh_main_bas_ksl
wh2_main_special_settlement_itza_emp	wh_main_bas_ksl
wh2_main_special_settlement_karaz_a_karak_emp	wh_main_bas_ksl
wh2_main_special_settlement_khemri_emp	wh_main_bas_ksl
wh2_main_special_settlement_lahmia_emp	wh_main_bas_ksl
wh2_main_special_settlement_lothern_emp	wh_main_bas_ksl
wh2_main_special_settlement_naggarond_emp	wh_main_bas_ksl
wh2_main_special_settlement_skavenblight_other	wh_main_bas_ksl
wh2_main_special_shrine_of_asuryan_other	wh_main_bas_ksl
wh2_main_special_shrine_of_khaine_other	wh_main_bas_ksl
wh2_main_special_tower_of_hoeth_emp	wh_main_bas_ksl
wh2_main_special_ziggurat_of_dawn_beacon	wh_main_bas_ksl
wh2_main_wef_oak_of_ages_occupied	wh_main_bas_ksl
wh_main_EMPIRE_barracks	wh_main_bas_ksl
wh_main_EMPIRE_farm_basic	wh_main_bas_ksl
wh_main_EMPIRE_forges	wh_main_bas_ksl
wh_main_EMPIRE_garrison	wh_main_bas_ksl
wh_main_EMPIRE_industry_basic	wh_main_bas_ksl
wh_main_EMPIRE_outpostnorsca_major	wh_main_bas_ksl
wh_main_EMPIRE_outpostnorsca_major_coast	wh_main_bas_ksl
wh_main_EMPIRE_outpostnorsca_minor	wh_main_bas_ksl
wh_main_EMPIRE_outpostnorsca_minor_coast	wh_main_bas_ksl
wh_main_EMPIRE_settlement_major	wh_main_bas_ksl
wh_main_EMPIRE_settlement_major_coast	wh_main_bas_ksl
wh_main_EMPIRE_settlement_minor	wh_main_bas_ksl
wh_main_EMPIRE_settlement_minor_coast	wh_main_bas_ksl
wh_main_EMPIRE_smiths	wh_main_bas_ksl
wh_main_EMPIRE_stables	wh_main_bas_ksl
wh_main_EMPIRE_tavern	wh_main_bas_ksl
wh_main_EMPIRE_wizards	wh_main_bas_ksl
wh_main_HUMAN_KISLEV_worship	wh_main_bas_ksl
wh_main_HUMAN_resource_dyes	wh_main_bas_ksl
wh_main_HUMAN_resource_furs	wh_main_bas_ksl
wh_main_HUMAN_resource_gold	wh_main_bas_ksl
wh_main_HUMAN_resource_iron	wh_main_bas_ksl
wh_main_HUMAN_resource_marble	wh_main_bas_ksl
wh_main_HUMAN_resource_pastures	wh_main_bas_ksl
wh_main_HUMAN_resource_pottery	wh_main_bas_ksl
wh_main_HUMAN_resource_salt	wh_main_bas_ksl
wh_main_HUMAN_resource_timber	wh_main_bas_ksl
wh_main_HUMAN_resource_wine	wh_main_bas_ksl
wh_main_KISLEV_port	wh_main_bas_ksl
wh_main_KISLEV_walls	wh_main_bas_ksl
wh_main_bretonnia_legendary_bordeleaux	wh_main_bas_ksl
wh_main_special_archecclesiatium	wh_main_bas_ksl
wh_main_special_blazing_sun_chapterhouse	wh_main_bas_ksl
wh_main_special_bokha_palace	wh_main_bas_ksl
wh_main_special_bordeleaux_vineyards	wh_main_bas_ksl
wh_main_special_college_of_magic	wh_main_bas_ksl
wh_main_special_erengrad_port	wh_main_bas_ksl
wh_main_special_great_temple_of_ulric	wh_main_bas_ksl
wh_main_special_knights_panther_chapterhouse	wh_main_bas_ksl
wh_main_special_marienburg_port	wh_main_bas_ksl
wh_main_special_nuln_gunnery_school	wh_main_bas_ksl
wh_main_special_settlement_altdorf	wh_main_bas_ksl
wh_main_special_settlement_castle_drakenhof_empire	wh_main_bas_ksl
wh_main_special_settlement_couronne_empire	wh_main_bas_ksl
wh_main_special_settlement_kislev	wh_main_bas_ksl
wh_main_special_settlement_miragliano_empire	wh_main_bas_ksl
wh_main_special_tournament_grounds	wh_main_bas_ksl
wh2_main_special_settlement_altdorf_norsca	wh_main_bas_nor
wh2_main_special_settlement_athel_loren_norsca	wh_main_bas_nor
wh2_main_special_settlement_castle_drakenhof_norsca	wh_main_bas_nor
wh2_main_special_settlement_colony_major_other	wh_main_bas_nor
wh2_main_special_settlement_colony_minor_other	wh_main_bas_nor
wh2_main_special_settlement_couronne_norsca	wh_main_bas_nor
wh2_main_special_settlement_hellpit_other	wh_main_bas_nor
wh2_main_special_settlement_hexoatl_norsca	wh_main_bas_nor
wh2_main_special_settlement_itza_norsca	wh_main_bas_nor
wh2_main_special_settlement_khemri_norsca	wh_main_bas_nor
wh2_main_special_settlement_kislev_norsca	wh_main_bas_nor
wh2_main_special_settlement_lahmia_norsca	wh_main_bas_nor
wh2_main_special_settlement_lothern_norsca	wh_main_bas_nor
wh2_main_special_settlement_miragliano_norsca	wh_main_bas_nor
wh2_main_special_settlement_naggarond_norsca	wh_main_bas_nor
wh2_main_special_settlement_skavenblight_other	wh_main_bas_nor
wh2_main_special_shrine_of_asuryan_other	wh_main_bas_nor
wh2_main_special_shrine_of_khaine_other	wh_main_bas_nor
wh2_main_special_ziggurat_of_dawn_beacon_chs	wh_main_bas_nor
wh2_main_wef_oak_of_ages_occupied	wh_main_bas_nor
wh_main_NORSCA_garrison	wh_main_bas_nor
wh_main_NORSCA_military	wh_main_bas_nor
wh_main_NORSCA_outpost_major_human	wh_main_bas_nor
wh_main_NORSCA_outpost_major_human_coast	wh_main_bas_nor
wh_main_NORSCA_outpost_minor_human	wh_main_bas_nor
wh_main_NORSCA_outpost_minor_human_coast	wh_main_bas_nor
wh_main_NORSCA_port	wh_main_bas_nor
wh_main_NORSCA_settlement_major	wh_main_bas_nor
wh_main_NORSCA_settlement_major_coast	wh_main_bas_nor
wh_main_NORSCA_settlement_minor	wh_main_bas_nor
wh_main_NORSCA_settlement_minor_coast	wh_main_bas_nor
wh_main_NORSCA_smith	wh_main_bas_nor
wh_main_NORSCA_stables	wh_main_bas_nor
wh_main_NORSCA_worship	wh_main_bas_nor
wh_main_special_settlement_black_crag_norsca	wh_main_bas_nor
wh_main_special_settlement_eight_peaks_norsca	wh_main_bas_nor
wh_main_special_settlement_karaz_a_karak_norsca	wh_main_bas_nor
wh2_main_special_big_fort	wh_main_bas_orc
wh2_main_special_dorks_rock	wh_main_bas_orc
wh2_main_special_fortress_gate_eagle_untainted	wh_main_bas_orc
wh2_main_special_fortress_gate_griffon_untainted	wh_main_bas_orc
wh2_main_special_fortress_gate_phoenix_untainted	wh_main_bas_orc
wh2_main_special_fortress_gate_unicorn_untainted	wh_main_bas_orc
wh2_main_special_settlement_hellpit_other	wh_main_bas_orc
wh2_main_special_settlement_skavenblight_other	wh_main_bas_orc
wh2_main_wef_oak_of_ages_occupied	wh_main_bas_orc
wh_dlc06_GREENSKIN_boars_skarsnik	wh_main_bas_orc
wh_dlc06_GREENSKIN_garrison_skarsnik	wh_main_bas_orc
wh_dlc06_GREENSKIN_garrison_wurrzag	wh_main_bas_orc
wh_dlc06_GREENSKIN_military_skarsnik	wh_main_bas_orc
wh_dlc06_GREENSKIN_outpostnorsca_major_coast_skarsnik	wh_main_bas_orc
wh_dlc06_GREENSKIN_outpostnorsca_major_coast_wurrzag	wh_main_bas_orc
wh_dlc06_GREENSKIN_outpostnorsca_major_skarsnik	wh_main_bas_orc
wh_dlc06_GREENSKIN_outpostnorsca_major_wurrzag	wh_main_bas_orc
wh_dlc06_GREENSKIN_outpostnorsca_minor_coast_skarsnik	wh_main_bas_orc
wh_dlc06_GREENSKIN_outpostnorsca_minor_coast_wurrzag	wh_main_bas_orc
wh_dlc06_GREENSKIN_outpostnorsca_minor_skarsnik	wh_main_bas_orc
wh_dlc06_GREENSKIN_outpostnorsca_minor_wurrzag	wh_main_bas_orc
wh_dlc06_GREENSKIN_settlement_major_coast_skarsnik	wh_main_bas_orc
wh_dlc06_GREENSKIN_settlement_major_coast_wurrzag	wh_main_bas_orc
wh_dlc06_GREENSKIN_settlement_major_skarsnik	wh_main_bas_orc
wh_dlc06_GREENSKIN_settlement_major_wurrzag	wh_main_bas_orc
wh_dlc06_GREENSKIN_settlement_minor_coast_skarsnik	wh_main_bas_orc
wh_dlc06_GREENSKIN_settlement_minor_coast_wurrzag	wh_main_bas_orc
wh_dlc06_GREENSKIN_settlement_minor_skarsnik	wh_main_bas_orc
wh_dlc06_GREENSKIN_settlement_minor_wurrzag	wh_main_bas_orc
wh_dlc06_GREENSKIN_walls_skarsnik	wh_main_bas_orc
wh_dlc06_GREENSKIN_walls_wurrzag	wh_main_bas_orc
wh_dlc06_special_savage_orc_camp_wurrzag	wh_main_bas_orc
wh_main_GREENSKIN_boars	wh_main_bas_orc
wh_main_GREENSKIN_boss	wh_main_bas_orc
wh_main_GREENSKIN_boss_skarsnik	wh_main_bas_orc
wh_main_GREENSKIN_farm	wh_main_bas_orc
wh_main_GREENSKIN_garrison	wh_main_bas_orc
wh_main_GREENSKIN_industry	wh_main_bas_orc
wh_main_GREENSKIN_military	wh_main_bas_orc
wh_main_GREENSKIN_monsters	wh_main_bas_orc
wh_main_GREENSKIN_outpostnorsca_major	wh_main_bas_orc
wh_main_GREENSKIN_outpostnorsca_major_coast	wh_main_bas_orc
wh_main_GREENSKIN_outpostnorsca_minor	wh_main_bas_orc
wh_main_GREENSKIN_outpostnorsca_minor_coast	wh_main_bas_orc
wh_main_GREENSKIN_settlement_major	wh_main_bas_orc
wh_main_GREENSKIN_settlement_major_coast	wh_main_bas_orc
wh_main_GREENSKIN_settlement_minor	wh_main_bas_orc
wh_main_GREENSKIN_settlement_minor_coast	wh_main_bas_orc
wh_main_GREENSKIN_shaman	wh_main_bas_orc
wh_main_GREENSKIN_walls	wh_main_bas_orc
wh_main_GREENSKIN_workshop	wh_main_bas_orc
wh_main_special_savage_orc_camp	wh_main_bas_orc
wh_main_special_settlement_karaz_a_karak_greenskins	wh_main_bas_orc
wh2_main_savageorc_defence_norsca	wh_main_bas_savorc
wh2_main_special_fortress_gate_eagle_untainted	wh_main_bas_savorc
wh2_main_special_fortress_gate_griffon_untainted	wh_main_bas_savorc
wh2_main_special_fortress_gate_phoenix_untainted	wh_main_bas_savorc
wh2_main_special_fortress_gate_unicorn_untainted	wh_main_bas_savorc
wh2_main_special_golden_tower_of_the_gods_other	wh_main_bas_savorc
wh2_main_special_pyramid_of_nagash_other	wh_main_bas_savorc
wh2_main_special_settlement_altdorf_savage	wh_main_bas_savorc
wh2_main_special_settlement_athel_loren_savage	wh_main_bas_savorc
wh2_main_special_settlement_castle_drakenhof_savage	wh_main_bas_savorc
wh2_main_special_settlement_colony_major_other	wh_main_bas_savorc
wh2_main_special_settlement_colony_minor_other	wh_main_bas_savorc
wh2_main_special_settlement_couronne_savage	wh_main_bas_savorc
wh2_main_special_settlement_hellpit_other	wh_main_bas_savorc
wh2_main_special_settlement_hexoatl_savage	wh_main_bas_savorc
wh2_main_special_settlement_itza_savage	wh_main_bas_savorc
wh2_main_special_settlement_khemri_savage	wh_main_bas_savorc
wh2_main_special_settlement_kislev_savage	wh_main_bas_savorc
wh2_main_special_settlement_lahmia_savage	wh_main_bas_savorc
wh2_main_special_settlement_lothern_savage	wh_main_bas_savorc
wh2_main_special_settlement_miragliano_savage	wh_main_bas_savorc
wh2_main_special_settlement_naggarond_savage	wh_main_bas_savorc
wh2_main_special_settlement_skavenblight_other	wh_main_bas_savorc
wh2_main_special_shrine_of_asuryan_other	wh_main_bas_savorc
wh2_main_special_shrine_of_khaine_other	wh_main_bas_savorc
wh2_main_wef_oak_of_ages_occupied	wh_main_bas_savorc
wh_main_GREENSKIN_boss	wh_main_bas_savorc
wh_main_GREENSKIN_boss_skarsnik	wh_main_bas_savorc
wh_main_GREENSKIN_farm	wh_main_bas_savorc
wh_main_GREENSKIN_industry	wh_main_bas_savorc
wh_main_GREENSKIN_monsters	wh_main_bas_savorc
wh_main_GREENSKIN_port	wh_main_bas_savorc
wh_main_GREENSKIN_walls	wh_main_bas_savorc
wh_main_SAVAGEORC_boars	wh_main_bas_savorc
wh_main_SAVAGEORC_boss	wh_main_bas_savorc
wh_main_SAVAGEORC_garrison	wh_main_bas_savorc
wh_main_SAVAGEORC_military	wh_main_bas_savorc
wh_main_SAVAGEORC_outpostnorsca_major	wh_main_bas_savorc
wh_main_SAVAGEORC_outpostnorsca_major_coast	wh_main_bas_savorc
wh_main_SAVAGEORC_outpostnorsca_minor	wh_main_bas_savorc
wh_main_SAVAGEORC_outpostnorsca_minor_coast	wh_main_bas_savorc
wh_main_SAVAGEORC_settlement_major	wh_main_bas_savorc
wh_main_SAVAGEORC_settlement_major_coast	wh_main_bas_savorc
wh_main_SAVAGEORC_settlement_minor	wh_main_bas_savorc
wh_main_SAVAGEORC_settlement_minor_coast	wh_main_bas_savorc
wh_main_horde_SAVAGEORC_boars	wh_main_bas_savorc
wh_main_horde_SAVAGEORC_farm	wh_main_bas_savorc
wh_main_horde_SAVAGEORC_industry	wh_main_bas_savorc
wh_main_horde_SAVAGEORC_military	wh_main_bas_savorc
wh_main_horde_SAVAGEORC_monsters	wh_main_bas_savorc
wh_main_horde_SAVAGEORC_settlement	wh_main_bas_savorc
wh_main_special_settlement_black_crag_savage	wh_main_bas_savorc
wh_main_special_settlement_eight_peaks_savage	wh_main_bas_savorc
wh_main_special_settlement_karaz_a_karak_savage	wh_main_bas_savorc
wh2_main_EMPIRE_academy	wh_main_bas_teb
wh2_main_EMPIRE_roads	wh_main_bas_teb
wh2_main_HUMAN_resource_gemstones	wh_main_bas_teb
wh2_main_emp_defence_norsca	wh_main_bas_teb
wh2_main_emp_resource_animals	wh_main_bas_teb
wh2_main_emp_resource_medicine	wh_main_bas_teb
wh2_main_emp_resource_obsidian	wh_main_bas_teb
wh2_main_emp_resource_spices	wh_main_bas_teb
wh2_main_special_altdorf_imperial_palace	wh_main_bas_teb
wh2_main_special_chamber_of_visions	wh_main_bas_teb
wh2_main_special_clar_karond_lairs_other	wh_main_bas_teb
wh2_main_special_fortress_gate_eagle_untainted	wh_main_bas_teb
wh2_main_special_fortress_gate_griffon_untainted	wh_main_bas_teb
wh2_main_special_fortress_gate_phoenix_untainted	wh_main_bas_teb
wh2_main_special_fortress_gate_unicorn_untainted	wh_main_bas_teb
wh2_main_special_ghrond_convent_of_sorcery_emp	wh_main_bas_teb
wh2_main_special_glittering_tower	wh_main_bas_teb
wh2_main_special_golden_tower_of_the_gods_other	wh_main_bas_teb
wh2_main_special_hag_graef_mines	wh_main_bas_teb
wh2_main_special_hexoatl_stellar_pyramids_other	wh_main_bas_teb
wh2_main_special_itza_emerald_pools	wh_main_bas_teb
wh2_main_special_lothern_port_other	wh_main_bas_teb
wh2_main_special_quintex	wh_main_bas_teb
wh2_main_special_settlement_athel_loren_emp	wh_main_bas_teb
wh2_main_special_settlement_black_crag_emp	wh_main_bas_teb
wh2_main_special_settlement_colony_major_other	wh_main_bas_teb
wh2_main_special_settlement_colony_minor_other	wh_main_bas_teb
wh2_main_special_settlement_eight_peaks_emp	wh_main_bas_teb
wh2_main_special_settlement_hellpit_other	wh_main_bas_teb
wh2_main_special_settlement_hexoatl_emp	wh_main_bas_teb
wh2_main_special_settlement_itza_emp	wh_main_bas_teb
wh2_main_special_settlement_karaz_a_karak_emp	wh_main_bas_teb
wh2_main_special_settlement_khemri_emp	wh_main_bas_teb
wh2_main_special_settlement_lahmia_emp	wh_main_bas_teb
wh2_main_special_settlement_lothern_emp	wh_main_bas_teb
wh2_main_special_settlement_naggarond_emp	wh_main_bas_teb
wh2_main_special_settlement_skavenblight_other	wh_main_bas_teb
wh2_main_special_shrine_of_asuryan_other	wh_main_bas_teb
wh2_main_special_shrine_of_khaine_other	wh_main_bas_teb
wh2_main_special_tower_of_hoeth_emp	wh_main_bas_teb
wh2_main_special_ziggurat_of_dawn_beacon	wh_main_bas_teb
wh2_main_wef_oak_of_ages_occupied	wh_main_bas_teb
wh_main_EMPIRE_barracks	wh_main_bas_teb
wh_main_EMPIRE_farm_basic	wh_main_bas_teb
wh_main_EMPIRE_forges	wh_main_bas_teb
wh_main_EMPIRE_garrison	wh_main_bas_teb
wh_main_EMPIRE_industry_basic	wh_main_bas_teb
wh_main_EMPIRE_outpostnorsca_major	wh_main_bas_teb
wh_main_EMPIRE_outpostnorsca_major_coast	wh_main_bas_teb
wh_main_EMPIRE_outpostnorsca_minor	wh_main_bas_teb
wh_main_EMPIRE_outpostnorsca_minor_coast	wh_main_bas_teb
wh_main_EMPIRE_settlement_major	wh_main_bas_teb
wh_main_EMPIRE_settlement_major_coast	wh_main_bas_teb
wh_main_EMPIRE_settlement_minor	wh_main_bas_teb
wh_main_EMPIRE_settlement_minor_coast	wh_main_bas_teb
wh_main_EMPIRE_smiths	wh_main_bas_teb
wh_main_EMPIRE_stables	wh_main_bas_teb
wh_main_EMPIRE_tavern	wh_main_bas_teb
wh_main_EMPIRE_wizards	wh_main_bas_teb
wh_main_HUMAN_TEB_worship	wh_main_bas_teb
wh_main_HUMAN_resource_dyes	wh_main_bas_teb
wh_main_HUMAN_resource_furs	wh_main_bas_teb
wh_main_HUMAN_resource_gold	wh_main_bas_teb
wh_main_HUMAN_resource_iron	wh_main_bas_teb
wh_main_HUMAN_resource_marble	wh_main_bas_teb
wh_main_HUMAN_resource_pastures	wh_main_bas_teb
wh_main_HUMAN_resource_pottery	wh_main_bas_teb
wh_main_HUMAN_resource_salt	wh_main_bas_teb
wh_main_HUMAN_resource_timber	wh_main_bas_teb
wh_main_HUMAN_resource_wine	wh_main_bas_teb
wh_main_TEB_port	wh_main_bas_teb
wh_main_TEB_walls	wh_main_bas_teb
wh_main_bretonnia_legendary_bordeleaux	wh_main_bas_teb
wh_main_special_archecclesiatium	wh_main_bas_teb
wh_main_special_blazing_sun_chapterhouse	wh_main_bas_teb
wh_main_special_bokha_palace	wh_main_bas_teb
wh_main_special_bordeleaux_vineyards	wh_main_bas_teb
wh_main_special_college_of_magic	wh_main_bas_teb
wh_main_special_erengrad_port	wh_main_bas_teb
wh_main_special_great_temple_of_ulric	wh_main_bas_teb
wh_main_special_knights_panther_chapterhouse	wh_main_bas_teb
wh_main_special_marienburg_port	wh_main_bas_teb
wh_main_special_nuln_gunnery_school	wh_main_bas_teb
wh_main_special_settlement_altdorf	wh_main_bas_teb
wh_main_special_settlement_castle_drakenhof_empire	wh_main_bas_teb
wh_main_special_settlement_couronne_empire	wh_main_bas_teb
wh_main_special_settlement_kislev_empire	wh_main_bas_teb
wh_main_special_settlement_miragliano	wh_main_bas_teb
wh_main_special_tournament_grounds	wh_main_bas_teb
wh2_main_VAMPIRES_raisedead	wh_main_bas_vmp
wh2_main_VAMPIRES_resource_animals	wh_main_bas_vmp
wh2_main_VAMPIRES_resource_gemstones	wh_main_bas_vmp
wh2_main_VAMPIRES_resource_medicine	wh_main_bas_vmp
wh2_main_VAMPIRES_resource_obsidian	wh_main_bas_vmp
wh2_main_VAMPIRES_terrorgheists	wh_main_bas_vmp
wh2_main_VAMPIRES_wraiths	wh_main_bas_vmp
wh2_main_special_altar_of_ultimate_darkness_vmp	wh_main_bas_vmp
wh2_main_special_altdorf_imperial_palace_vmp	wh_main_bas_vmp
wh2_main_special_blood_keep	wh_main_bas_vmp
wh2_main_special_clar_karond_lairs_vmp	wh_main_bas_vmp
wh2_main_special_drakenhof_court	wh_main_bas_vmp
wh2_main_special_fortress_gate_eagle_vmp	wh_main_bas_vmp
wh2_main_special_fortress_gate_griffon_vmp	wh_main_bas_vmp
wh2_main_special_fortress_gate_phoenix_vmp	wh_main_bas_vmp
wh2_main_special_fortress_gate_unicorn_vmp	wh_main_bas_vmp
wh2_main_special_ghrond_convent_of_sorcery_vmp	wh_main_bas_vmp
wh2_main_special_golden_tower_of_the_gods_other	wh_main_bas_vmp
wh2_main_special_lothern_port_other	wh_main_bas_vmp
wh2_main_special_mousillon_merovech	wh_main_bas_vmp
wh2_main_special_pyramid_of_nagash_vmp	wh_main_bas_vmp
wh2_main_special_settlement_athel_loren_vmp	wh_main_bas_vmp
wh2_main_special_settlement_black_crag_vmp	wh_main_bas_vmp
wh2_main_special_settlement_colony_major_other	wh_main_bas_vmp
wh2_main_special_settlement_colony_minor_other	wh_main_bas_vmp
wh2_main_special_settlement_eight_peaks_vmp	wh_main_bas_vmp
wh2_main_special_settlement_hellpit_other	wh_main_bas_vmp
wh2_main_special_settlement_hexoatl_vmp	wh_main_bas_vmp
wh2_main_special_settlement_itza_vmp	wh_main_bas_vmp
wh2_main_special_settlement_karaz_a_karak_vmp	wh_main_bas_vmp
wh2_main_special_settlement_khemri_vmp	wh_main_bas_vmp
wh2_main_special_settlement_lahmia_vmp	wh_main_bas_vmp
wh2_main_special_settlement_lothern_vmp	wh_main_bas_vmp
wh2_main_special_settlement_naggarond_vmp	wh_main_bas_vmp
wh2_main_special_settlement_skavenblight_other	wh_main_bas_vmp
wh2_main_special_shrine_of_asuryan_vmp	wh_main_bas_vmp
wh2_main_special_shrine_of_khaine_vmp	wh_main_bas_vmp
wh2_main_special_ziggurat_of_dawn_beacon_vmp	wh_main_bas_vmp
wh2_main_vmp_defence_norsca	wh_main_bas_vmp
wh2_main_vmp_resource_spices	wh_main_bas_vmp
wh2_main_wef_oak_of_ages_occupied	wh_main_bas_vmp
wh_main_VAMPIRES_armoury	wh_main_bas_vmp
wh_main_VAMPIRES_balefire	wh_main_bas_vmp
wh_main_VAMPIRES_bindingcircle	wh_main_bas_vmp
wh_main_VAMPIRES_cemetary	wh_main_bas_vmp
wh_main_VAMPIRES_forest	wh_main_bas_vmp
wh_main_VAMPIRES_garrison	wh_main_bas_vmp
wh_main_VAMPIRES_necromancers	wh_main_bas_vmp
wh_main_VAMPIRES_ossuary	wh_main_bas_vmp
wh_main_VAMPIRES_outpostnorsca_major	wh_main_bas_vmp
wh_main_VAMPIRES_outpostnorsca_major_coast	wh_main_bas_vmp
wh_main_VAMPIRES_outpostnorsca_minor	wh_main_bas_vmp
wh_main_VAMPIRES_outpostnorsca_minor_coast	wh_main_bas_vmp
wh_main_VAMPIRES_port	wh_main_bas_vmp
wh_main_VAMPIRES_repression	wh_main_bas_vmp
wh_main_VAMPIRES_resource_dyes	wh_main_bas_vmp
wh_main_VAMPIRES_resource_furs	wh_main_bas_vmp
wh_main_VAMPIRES_resource_gold	wh_main_bas_vmp
wh_main_VAMPIRES_resource_iron	wh_main_bas_vmp
wh_main_VAMPIRES_resource_marble	wh_main_bas_vmp
wh_main_VAMPIRES_resource_pastures	wh_main_bas_vmp
wh_main_VAMPIRES_resource_pottery	wh_main_bas_vmp
wh_main_VAMPIRES_resource_salt	wh_main_bas_vmp
wh_main_VAMPIRES_resource_timber	wh_main_bas_vmp
wh_main_VAMPIRES_resource_wine	wh_main_bas_vmp
wh_main_VAMPIRES_settlement_major	wh_main_bas_vmp
wh_main_VAMPIRES_settlement_major_coast	wh_main_bas_vmp
wh_main_VAMPIRES_settlement_minor	wh_main_bas_vmp
wh_main_VAMPIRES_settlement_minor_coast	wh_main_bas_vmp
wh_main_VAMPIRES_vampires	wh_main_bas_vmp
wh_main_VAMPIRES_walls	wh_main_bas_vmp
wh_main_bretonnia_legendary_bordeleaux	wh_main_bas_vmp
wh_main_special_bokha_palace	wh_main_bas_vmp
wh_main_special_bordeleaux_vineyards	wh_main_bas_vmp
wh_main_special_college_of_magic_vampires	wh_main_bas_vmp
wh_main_special_erengrad_port	wh_main_bas_vmp
wh_main_special_marienburg_port	wh_main_bas_vmp
wh_main_special_settlement_altdorf_vampires	wh_main_bas_vmp
wh_main_special_settlement_castle_drakenhof	wh_main_bas_vmp
wh_main_special_settlement_couronne_vampires	wh_main_bas_vmp
wh_main_special_settlement_kislev_vampires	wh_main_bas_vmp
wh_main_special_settlement_miragliano_vampires	wh_main_bas_vmp
wh_pro02_VAMPIRES_isabella_unique	wh_main_bas_vmp
