unit_class_tables
5
key	onscreen	sort_priority
art_fix	Fixed Artillery	11
art_fld	Field Artillery	10
art_siege	Siege Artillery	12
cav_mel	Melee Cavalry	4
cav_mis	Missile Cavalry	5
cav_shk	Shock Cavalry	3
chariot	Chariot	2
com	Command	0
elph	Elephant	1
inf_mel	Melee Infantry	7
inf_mis	Missile Infantry	9
inf_pik	Pike Infantry	6
inf_spr	Spear Infantry	8
shp_art	Artillery Ship	1
shp_mel	Melee Ship	2
shp_mis	Missile Ship	3
shp_trn	Transport Ship	4
spcl	Special	13
