military_force_legacy_names_tables
1
key	subculture	for_army
wh2_main_def_legacy_01	wh2_main_sc_def_dark_elves	True
wh2_main_def_legacy_navy_01	wh2_main_sc_def_dark_elves	False
wh2_main_hef_legacy_01	wh2_main_sc_hef_high_elves	True
wh2_main_hef_legacy_navy_01	wh2_main_sc_hef_high_elves	False
wh2_main_lzd_legacy_01	wh2_main_sc_lzd_lizardmen	True
wh2_main_lzd_legacy_navy_01	wh2_main_sc_lzd_lizardmen	False
wh2_main_rogue_abominations_01	wh2_main_rogue_abominations	True
wh2_main_rogue_abominations_navy_01	wh2_main_rogue_abominations	False
wh2_main_rogue_beastcatchas_01	wh2_main_rogue_beastcatchas	True
wh2_main_rogue_beastcatchas_navy_01	wh2_main_rogue_beastcatchas	False
wh2_main_rogue_bernhoffs_brigands_01	wh2_main_rogue_bernhoffs_brigands	True
wh2_main_rogue_bernhoffs_brigands_navy_01	wh2_main_rogue_bernhoffs_brigands	False
wh2_main_rogue_black_spider_tribe_01	wh2_main_rogue_black_spider_tribe	True
wh2_main_rogue_black_spider_tribe_navy_01	wh2_main_rogue_black_spider_tribe	False
wh2_main_rogue_boneclubbers_tribe_01	wh2_main_rogue_boneclubbers_tribe	True
wh2_main_rogue_boneclubbers_tribe_navy_01	wh2_main_rogue_boneclubbers_tribe	False
wh2_main_rogue_celestial_storm_01	wh2_main_rogue_celestial_storm	True
wh2_main_rogue_celestial_storm_navy_01	wh2_main_rogue_celestial_storm	False
wh2_main_rogue_college_of_pyrotechnics_legacy_01	wh2_main_rogue_college_of_pyrotechnics	True
wh2_main_rogue_college_of_pyrotechnics_legacy_navy_01	wh2_main_rogue_college_of_pyrotechnics	False
wh2_main_rogue_doomseekers_01	wh2_main_rogue_doomseekers	True
wh2_main_rogue_doomseekers_navy_01	wh2_main_rogue_doomseekers	False
wh2_main_rogue_gerhardts_mercenaries_01	wh2_main_rogue_gerhardts_mercenaries	True
wh2_main_rogue_gerhardts_mercenaries_navy_01	wh2_main_rogue_gerhardts_mercenaries	False
wh2_main_rogue_heirs_of_mourkain_legacy_01	wh2_main_rogue_heirs_of_mourkain	True
wh2_main_rogue_heirs_of_mourkain_legacy_navy_01	wh2_main_rogue_heirs_of_mourkain	False
wh2_main_rogue_hung_warband_01	wh2_main_rogue_hung_warband	True
wh2_main_rogue_hung_warband_navy_01	wh2_main_rogue_hung_warband	False
wh2_main_rogue_hunters_of_kurnous_legacy_01	wh2_main_rogue_hunters_of_kurnous	True
wh2_main_rogue_hunters_of_kurnous_legacy_navy_01	wh2_main_rogue_hunters_of_kurnous	False
wh2_main_rogue_jerrods_errantry_01	wh2_main_rogue_jerrods_errantry	True
wh2_main_rogue_jerrods_errantry_navy_01	wh2_main_rogue_jerrods_errantry	False
wh2_main_rogue_mangy_houndz_01	wh2_main_rogue_mangy_houndz	True
wh2_main_rogue_mangy_houndz_navy_01	wh2_main_rogue_mangy_houndz	False
wh2_main_rogue_mengils_manflayers_legacy_01	wh2_main_rogue_mengils_manflayers	True
wh2_main_rogue_mengils_manflayers_legacy_navy_01	wh2_main_rogue_mengils_manflayers	False
wh2_main_rogue_morrsliebs_howlers_01	wh2_main_rogue_morrsliebs_howlers	True
wh2_main_rogue_morrsliebs_howlers_navy_01	wh2_main_rogue_morrsliebs_howlers	False
wh2_main_rogue_pirates_of_the_far_sea_01	wh2_main_rogue_pirates_of_the_far_sea	True
wh2_main_rogue_pirates_of_the_far_sea_navy_01	wh2_main_rogue_pirates_of_the_far_sea	False
wh2_main_rogue_pirates_of_the_southern_ocean_01	wh2_main_rogue_pirates_of_the_southern_ocean	True
wh2_main_rogue_pirates_of_the_southern_ocean_navy_01	wh2_main_rogue_pirates_of_the_southern_ocean	False
wh2_main_rogue_pirates_of_trantio_01	wh2_main_rogue_pirates_of_trantio	True
wh2_main_rogue_pirates_of_trantio_navy_01	wh2_main_rogue_pirates_of_trantio	False
wh2_main_rogue_scions_of_tesseninck_01	wh2_main_rogue_scions_of_tesseninck	True
wh2_main_rogue_scions_of_tesseninck_navy_01	wh2_main_rogue_scions_of_tesseninck	False
wh2_main_rogue_scourge_of_aquitaine_01	wh2_main_rogue_scourge_of_aquitaine	True
wh2_main_rogue_scourge_of_aquitaine_navy_01	wh2_main_rogue_scourge_of_aquitaine	False
wh2_main_rogue_stuff_snatchers_01	wh2_main_rogue_stuff_snatchers	True
wh2_main_rogue_stuff_snatchers_navy_01	wh2_main_rogue_stuff_snatchers	False
wh2_main_rogue_teef_snatchaz_01	wh2_main_rogue_teef_snatchaz	True
wh2_main_rogue_teef_snatchaz_navy_01	wh2_main_rogue_teef_snatchaz	False
wh2_main_rogue_the_wandering_dead_01	wh2_main_rogue_the_wandering_dead	True
wh2_main_rogue_the_wandering_dead_navy_01	wh2_main_rogue_the_wandering_dead	False
wh2_main_rogue_tor_elithis_legacy_01	wh2_main_rogue_tor_elithis	True
wh2_main_rogue_tor_elithis_legacy_navy_01	wh2_main_rogue_tor_elithis	False
wh2_main_rogue_troll_skullz_legacy_01	wh2_main_rogue_troll_skullz	True
wh2_main_rogue_troll_skullz_legacy_navy_01	wh2_main_rogue_troll_skullz	False
wh2_main_rogue_vashnaar_legacy_01	wh2_main_rogue_vashnaar	True
wh2_main_rogue_vashnaar_legacy_navy_01	wh2_main_rogue_vashnaar	False
wh2_main_rogue_vauls_expedition_01	wh2_main_rogue_vauls_expedition	True
wh2_main_rogue_vauls_expedition_navy_01	wh2_main_rogue_vauls_expedition	False
wh2_main_rogue_worldroot_rangers_01	wh2_main_rogue_worldroot_rangers	True
wh2_main_rogue_worldroot_rangers_navy_01	wh2_main_rogue_worldroot_rangers	False
wh2_main_rogue_wrath_of_nature_01	wh2_main_rogue_wrath_of_nature	True
wh2_main_rogue_wrath_of_nature_navy_01	wh2_main_rogue_wrath_of_nature	False
wh2_main_skv_legacy_01	wh2_main_sc_skv_skaven	True
wh2_main_skv_legacy_navy_01	wh2_main_sc_skv_skaven	False
wh_dlc03_bst_legacy_01	wh_dlc03_sc_bst_beastmen	True
wh_dlc03_bst_legacy_navy_01	wh_dlc03_sc_bst_beastmen	False
wh_dlc05_wef_legacy_01	wh_dlc05_sc_wef_wood_elves	True
wh_dlc05_wef_legacy_navy_01	wh_dlc05_sc_wef_wood_elves	False
wh_main_brt_legacy_01	wh_main_sc_brt_bretonnia	True
wh_main_brt_legacy_navy_01	wh_main_sc_brt_bretonnia	False
wh_main_chs_legacy_01	wh_main_sc_chs_chaos	True
wh_main_chs_legacy_navy_01	wh_main_sc_chs_chaos	False
wh_main_dwf_legacy_01	wh_main_sc_dwf_dwarfs	True
wh_main_dwf_legacy_navy_01	wh_main_sc_dwf_dwarfs	False
wh_main_emp_legacy_01	wh_main_sc_emp_empire	True
wh_main_emp_legacy_navy_01	wh_main_sc_emp_empire	False
wh_main_grn_legacy_01	wh_main_sc_grn_greenskins	True
wh_main_grn_legacy_01	wh_main_sc_grn_savage_orcs	True
wh_main_grn_legacy_navy_01	wh_main_sc_grn_greenskins	False
wh_main_grn_legacy_navy_01	wh_main_sc_grn_savage_orcs	False
wh_main_ksl_legacy_01	wh_main_sc_ksl_kislev	True
wh_main_ksl_legacy_navy_01	wh_main_sc_ksl_kislev	False
wh_main_nor_legacy_01	wh_main_sc_nor_norsca	True
wh_main_nor_legacy_navy_01	wh_main_sc_nor_norsca	False
wh_main_teb_legacy_01	wh_main_sc_teb_teb	True
wh_main_teb_legacy_navy_01	wh_main_sc_teb_teb	False
wh_main_vmp_legacy_01	wh_main_sc_vmp_vampire_counts	True
wh_main_vmp_legacy_navy_01	wh_main_sc_vmp_vampire_counts	False
