ancillary_included_subcultures_tables
0
ancillary	subculture
wh2_main_anc_arcane_item_black_staff	wh2_main_sc_def_dark_elves
wh2_main_anc_arcane_item_book_of_hoeth	wh2_main_sc_hef_high_elves
wh2_main_anc_arcane_item_circlet_of_iron	wh2_main_sc_def_dark_elves
wh2_main_anc_arcane_item_cube_of_darkness	wh2_main_sc_lzd_lizardmen
wh2_main_anc_arcane_item_cupped_hands_of_the_old_ones	wh2_main_sc_lzd_lizardmen
wh2_main_anc_arcane_item_darkstar_cloak	wh2_main_sc_def_dark_elves
wh2_main_anc_arcane_item_diadem_of_power	wh2_main_sc_lzd_lizardmen
wh2_main_anc_arcane_item_itxi_grubs	wh2_main_sc_lzd_lizardmen
wh2_main_anc_arcane_item_jewel_of_the_dusk	wh2_main_sc_hef_high_elves
wh2_main_anc_arcane_item_moon_staff_of_lileath	wh2_main_sc_hef_high_elves
wh2_main_anc_arcane_item_plaque_of_dominion	wh2_main_sc_lzd_lizardmen
wh2_main_anc_arcane_item_rod_of_the_storm	wh2_main_sc_lzd_lizardmen
wh2_main_anc_arcane_item_scroll_of_hoeth	wh2_main_sc_hef_high_elves
wh2_main_anc_arcane_item_scrying_stone	wh2_main_sc_skv_skaven
wh2_main_anc_arcane_item_staff_of_solidity	wh2_main_sc_hef_high_elves
wh2_main_anc_arcane_item_starwood_staff	wh2_main_sc_hef_high_elves
wh2_main_anc_arcane_item_the_gem_of_sunfire	wh2_main_sc_hef_high_elves
wh2_main_anc_arcane_item_the_liber_bubonicus	wh2_main_sc_skv_skaven
wh2_main_anc_arcane_item_the_seerstaff_of_saphery	wh2_main_sc_hef_high_elves
wh2_main_anc_arcane_item_the_tricksters_pendant	wh2_main_sc_hef_high_elves
wh2_main_anc_arcane_item_the_vortex_shard	wh2_main_sc_hef_high_elves
wh2_main_anc_arcane_item_tome_of_furion	wh2_main_sc_def_dark_elves
wh2_main_anc_arcane_item_wand_of_the_kharaidon	wh2_main_sc_def_dark_elves
wh2_main_anc_arcane_item_war_crown_of_saphery	wh2_main_sc_hef_high_elves
wh2_main_anc_arcane_item_warp_energy_condenser	wh2_main_sc_skv_skaven
wh2_main_anc_arcane_item_warpstone_tokens	wh2_main_sc_skv_skaven
wh2_main_anc_arcane_item_warpstorm_scroll	wh2_main_sc_skv_skaven
wh2_main_anc_armour_armour_of_caledor	wh2_main_sc_hef_high_elves
wh2_main_anc_armour_armour_of_darkness	wh2_main_sc_def_dark_elves
wh2_main_anc_armour_armour_of_eternal_servitude	wh2_main_sc_def_dark_elves
wh2_main_anc_armour_armour_of_living_death	wh2_main_sc_def_dark_elves
wh2_main_anc_armour_armour_of_midnight	wh2_main_sc_def_dark_elves
wh2_main_anc_armour_armour_of_the_stars	wh2_main_sc_hef_high_elves
wh2_main_anc_armour_cloak_of_hag_graef	wh2_main_sc_def_dark_elves
wh2_main_anc_armour_crown_of_authority	wh2_main_sc_hef_high_elves
wh2_main_anc_armour_dragon_armour_of_aenarion	wh2_main_sc_hef_high_elves
wh2_main_anc_armour_dragonscale_shield	wh2_main_sc_hef_high_elves
wh2_main_anc_armour_enchanted_ithilmar_breastplate	wh2_main_sc_hef_high_elves
wh2_main_anc_armour_helm_of_fortune	wh2_main_sc_hef_high_elves
wh2_main_anc_armour_helm_of_khaine	wh2_main_sc_hef_high_elves
wh2_main_anc_armour_helm_of_the_kraken	wh2_main_sc_def_dark_elves
wh2_main_anc_armour_hide_of_the_cold_ones	wh2_main_sc_lzd_lizardmen
wh2_main_anc_armour_lions_pelt	wh2_main_sc_hef_high_elves
wh2_main_anc_armour_sacred_stegadon_helm_of_itza	wh2_main_sc_lzd_lizardmen
wh2_main_anc_armour_shadow_armour	wh2_main_sc_hef_high_elves
wh2_main_anc_armour_shield_of_distraction	wh2_main_sc_skv_skaven
wh2_main_anc_armour_shield_of_ghrond	wh2_main_sc_def_dark_elves
wh2_main_anc_armour_shield_of_the_merwyrm	wh2_main_sc_hef_high_elves
wh2_main_anc_armour_shield_of_the_mirrored_pool	wh2_main_sc_lzd_lizardmen
wh2_main_anc_armour_supreme_spellshield	wh2_main_sc_def_dark_elves
wh2_main_anc_armour_the_bane_shield	wh2_main_sc_hef_high_elves
wh2_main_anc_armour_the_maiming_shield	wh2_main_sc_lzd_lizardmen
wh2_main_anc_armour_warp_shard_armour	wh2_main_sc_skv_skaven
wh2_main_anc_armour_warpstone_armour	wh2_main_sc_skv_skaven
wh2_main_anc_armour_winged_boots	wh2_main_sc_hef_high_elves
wh2_main_anc_armour_worlds_edge_armour	wh2_main_sc_skv_skaven
wh2_main_anc_enchanted_item_black_dragon_egg	wh2_main_sc_def_dark_elves
wh2_main_anc_enchanted_item_blessed_tome	wh2_main_sc_hef_high_elves
wh2_main_anc_enchanted_item_blood_statuette_of_spite	wh2_main_sc_lzd_lizardmen
wh2_main_anc_enchanted_item_carnosaur_pendant	wh2_main_sc_lzd_lizardmen
wh2_main_anc_enchanted_item_chest_of_sustenance	wh2_main_sc_hef_high_elves
wh2_main_anc_enchanted_item_cloak_of_beards	wh2_main_sc_hef_high_elves
wh2_main_anc_enchanted_item_cloak_of_twilight	wh2_main_sc_def_dark_elves
wh2_main_anc_enchanted_item_curse_charm_of_tepok	wh2_main_sc_lzd_lizardmen
wh2_main_anc_enchanted_item_divine_plaque_of_protection	wh2_main_sc_lzd_lizardmen
wh2_main_anc_enchanted_item_dragonfly_of_quicksilver	wh2_main_sc_lzd_lizardmen
wh2_main_anc_enchanted_item_dragonhorn	wh2_main_sc_hef_high_elves
wh2_main_anc_enchanted_item_enchanted_spyglass	wh2_main_sc_hef_high_elves
wh2_main_anc_enchanted_item_folariaths_robe	wh2_main_sc_hef_high_elves
wh2_main_anc_enchanted_item_gilded_horn_of_galon_konook	wh2_main_sc_hef_high_elves
wh2_main_anc_enchanted_item_hand_of_gods	wh2_main_sc_lzd_lizardmen
wh2_main_anc_enchanted_item_heart_of_avelorn	wh2_main_sc_hef_high_elves
wh2_main_anc_enchanted_item_khaines_ring_of_fury	wh2_main_sc_hef_high_elves
wh2_main_anc_enchanted_item_moranions_wayshard	wh2_main_sc_hef_high_elves
wh2_main_anc_enchanted_item_pipes_of_piebald	wh2_main_sc_skv_skaven
wh2_main_anc_enchanted_item_portents_of_verminous_doom	wh2_main_sc_skv_skaven
wh2_main_anc_enchanted_item_radiant_gem_of_hoeth	wh2_main_sc_hef_high_elves
wh2_main_anc_enchanted_item_ring_of_corin	wh2_main_sc_hef_high_elves
wh2_main_anc_enchanted_item_ring_of_hukon	wh2_main_sc_hef_high_elves
wh2_main_anc_enchanted_item_rubric_of_dark_dimensions	wh2_main_sc_def_dark_elves
wh2_main_anc_enchanted_item_skalm	wh2_main_sc_skv_skaven
wh2_main_anc_enchanted_item_skavenbrew	wh2_main_sc_skv_skaven
wh2_main_anc_enchanted_item_talisman_of_loec	wh2_main_sc_hef_high_elves
wh2_main_anc_enchanted_item_the_book_of_the_phoenix	wh2_main_sc_hef_high_elves
wh2_main_anc_enchanted_item_the_cloak_of_feathers	wh2_main_sc_lzd_lizardmen
wh2_main_anc_enchanted_item_the_guiding_eye	wh2_main_sc_def_dark_elves
wh2_main_anc_enchanted_item_the_horn_of_kygor	wh2_main_sc_lzd_lizardmen
wh2_main_anc_enchanted_item_venom_of_the_firefly_frog	wh2_main_sc_lzd_lizardmen
wh2_main_anc_enchanted_item_war_drum_of_xahutec	wh2_main_sc_lzd_lizardmen
wh2_main_anc_enchanted_item_whip_of_agony	wh2_main_sc_def_dark_elves
wh2_main_anc_follower_def_apprentice_assassin	wh2_main_sc_def_dark_elves
wh2_main_anc_follower_def_beastmaster	wh2_main_sc_def_dark_elves
wh2_main_anc_follower_def_bodyguard	wh2_main_sc_def_dark_elves
wh2_main_anc_follower_def_cultist	wh2_main_sc_def_dark_elves
wh2_main_anc_follower_def_daemon_whisperer	wh2_main_sc_def_dark_elves
wh2_main_anc_follower_def_diplomat_slaanesh	wh2_main_sc_def_dark_elves
wh2_main_anc_follower_def_diplomat	wh2_main_sc_def_dark_elves
wh2_main_anc_follower_def_fanatic	wh2_main_sc_def_dark_elves
wh2_main_anc_follower_def_fimir_balefiend	wh2_main_sc_def_dark_elves
wh2_main_anc_follower_def_gravedigger	wh2_main_sc_def_dark_elves
wh2_main_anc_follower_def_harem_attendant	wh2_main_sc_def_dark_elves
wh2_main_anc_follower_def_harem_keeper	wh2_main_sc_def_dark_elves
wh2_main_anc_follower_def_merchant	wh2_main_sc_def_dark_elves
wh2_main_anc_follower_def_musician_choirmaster	wh2_main_sc_def_dark_elves
wh2_main_anc_follower_def_musician_drum	wh2_main_sc_def_dark_elves
wh2_main_anc_follower_def_musician_flute	wh2_main_sc_def_dark_elves
wh2_main_anc_follower_def_organ_merchant	wh2_main_sc_def_dark_elves
wh2_main_anc_follower_def_overseer	wh2_main_sc_def_dark_elves
wh2_main_anc_follower_def_propagandist	wh2_main_sc_def_dark_elves
wh2_main_anc_follower_def_servant	wh2_main_sc_def_dark_elves
wh2_main_anc_follower_def_slave_trader	wh2_main_sc_def_dark_elves
wh2_main_anc_follower_def_slave	wh2_main_sc_def_dark_elves
wh2_main_anc_follower_hef_admiral	wh2_main_sc_hef_high_elves
wh2_main_anc_follower_hef_assassin	wh2_main_sc_hef_high_elves
wh2_main_anc_follower_hef_bard	wh2_main_sc_hef_high_elves
wh2_main_anc_follower_hef_beard_weaver	wh2_main_sc_hef_high_elves
wh2_main_anc_follower_hef_counsellor	wh2_main_sc_hef_high_elves
wh2_main_anc_follower_hef_counterspy	wh2_main_sc_hef_high_elves
wh2_main_anc_follower_hef_dragon_armourer	wh2_main_sc_hef_high_elves
wh2_main_anc_follower_hef_dragon_tamer	wh2_main_sc_hef_high_elves
wh2_main_anc_follower_hef_food_taster	wh2_main_sc_hef_high_elves
wh2_main_anc_follower_hef_horsemaster	wh2_main_sc_hef_high_elves
wh2_main_anc_follower_hef_librarian	wh2_main_sc_hef_high_elves
wh2_main_anc_follower_hef_minstrel	wh2_main_sc_hef_high_elves
wh2_main_anc_follower_hef_poisoner	wh2_main_sc_hef_high_elves
wh2_main_anc_follower_hef_priest_vaul	wh2_main_sc_hef_high_elves
wh2_main_anc_follower_hef_priestess_isha	wh2_main_sc_hef_high_elves
wh2_main_anc_follower_hef_raven_keeper	wh2_main_sc_hef_high_elves
wh2_main_anc_follower_hef_scout	wh2_main_sc_hef_high_elves
wh2_main_anc_follower_hef_shrine_keeper	wh2_main_sc_hef_high_elves
wh2_main_anc_follower_hef_trappist	wh2_main_sc_hef_high_elves
wh2_main_anc_follower_hef_wine_merchant	wh2_main_sc_hef_high_elves
wh2_main_anc_follower_lzd_acolyte_priest	wh2_main_sc_lzd_lizardmen
wh2_main_anc_follower_lzd_architect	wh2_main_sc_lzd_lizardmen
wh2_main_anc_follower_lzd_archivist	wh2_main_sc_lzd_lizardmen
wh2_main_anc_follower_lzd_army_beast_hunter	wh2_main_sc_lzd_lizardmen
wh2_main_anc_follower_lzd_artefact_hunter	wh2_main_sc_lzd_lizardmen
wh2_main_anc_follower_lzd_astrologer	wh2_main_sc_lzd_lizardmen
wh2_main_anc_follower_lzd_astronomer	wh2_main_sc_lzd_lizardmen
wh2_main_anc_follower_lzd_attendant	wh2_main_sc_lzd_lizardmen
wh2_main_anc_follower_lzd_cleaner	wh2_main_sc_lzd_lizardmen
wh2_main_anc_follower_lzd_clerk	wh2_main_sc_lzd_lizardmen
wh2_main_anc_follower_lzd_defence_expert	wh2_main_sc_lzd_lizardmen
wh2_main_anc_follower_lzd_fan_waver	wh2_main_sc_lzd_lizardmen
wh2_main_anc_follower_lzd_gardener	wh2_main_sc_lzd_lizardmen
wh2_main_anc_follower_lzd_librarian	wh2_main_sc_lzd_lizardmen
wh2_main_anc_follower_lzd_metallurgist	wh2_main_sc_lzd_lizardmen
wh2_main_anc_follower_lzd_sacrificial_victim_human	wh2_main_sc_lzd_lizardmen
wh2_main_anc_follower_lzd_sacrificial_victim_skv	wh2_main_sc_lzd_lizardmen
wh2_main_anc_follower_lzd_temple_cleaner	wh2_main_sc_lzd_lizardmen
wh2_main_anc_follower_lzd_veteran_warrior	wh2_main_sc_lzd_lizardmen
wh2_main_anc_follower_lzd_zoat	wh2_main_sc_lzd_lizardmen
wh2_main_anc_follower_sea_cucumber	wh2_main_sc_skv_skaven
wh2_main_anc_follower_skv_artefact_hunter	wh2_main_sc_skv_skaven
wh2_main_anc_follower_skv_bell_polisher	wh2_main_sc_skv_skaven
wh2_main_anc_follower_skv_bodyguard	wh2_main_sc_skv_skaven
wh2_main_anc_follower_skv_chemist	wh2_main_sc_skv_skaven
wh2_main_anc_follower_skv_clerk	wh2_main_sc_skv_skaven
wh2_main_anc_follower_skv_engineering_student	wh2_main_sc_skv_skaven
wh2_main_anc_follower_skv_female	wh2_main_sc_skv_skaven
wh2_main_anc_follower_skv_hell_pit_attendant	wh2_main_sc_skv_skaven
wh2_main_anc_follower_skv_mechanic	wh2_main_sc_skv_skaven
wh2_main_anc_follower_skv_messenger	wh2_main_sc_skv_skaven
wh2_main_anc_follower_skv_pet_wolf_rat	wh2_main_sc_skv_skaven
wh2_main_anc_follower_skv_saboteur	wh2_main_sc_skv_skaven
wh2_main_anc_follower_skv_sacrificial_victim_dwarf	wh2_main_sc_skv_skaven
wh2_main_anc_follower_skv_sacrificial_victim_lizardman	wh2_main_sc_skv_skaven
wh2_main_anc_follower_skv_scavenger_1	wh2_main_sc_skv_skaven
wh2_main_anc_follower_skv_scribe	wh2_main_sc_skv_skaven
wh2_main_anc_follower_skv_sculptor	wh2_main_sc_skv_skaven
wh2_main_anc_follower_skv_slave_human	wh2_main_sc_skv_skaven
wh2_main_anc_follower_skv_slave_skv	wh2_main_sc_skv_skaven
wh2_main_anc_follower_skv_trainee_assassin	wh2_main_sc_skv_skaven
wh2_main_anc_magic_standard_banner_of_ellyrion	wh2_main_sc_hef_high_elves
wh2_main_anc_magic_standard_banner_of_murder	wh2_main_sc_def_dark_elves
wh2_main_anc_magic_standard_banner_of_the_under_empire	wh2_main_sc_skv_skaven
wh2_main_anc_magic_standard_banner_of_the_world_dragon	wh2_main_sc_hef_high_elves
wh2_main_anc_magic_standard_banner_of_verminous_scurrying	wh2_main_sc_skv_skaven
wh2_main_anc_magic_standard_battle_banner	wh2_main_sc_hef_high_elves
wh2_main_anc_magic_standard_dread_banner	wh2_main_sc_def_dark_elves
wh2_main_anc_magic_standard_dwarf_hide_banner	wh2_main_sc_skv_skaven
wh2_main_anc_magic_standard_grand_banner_of_clan_superiority	wh2_main_sc_skv_skaven
wh2_main_anc_magic_standard_horn_of_isha	wh2_main_sc_hef_high_elves
wh2_main_anc_magic_standard_huanchis_blessed_totem	wh2_main_sc_lzd_lizardmen
wh2_main_anc_magic_standard_hydra_banner	wh2_main_sc_def_dark_elves
wh2_main_anc_magic_standard_lion_standard	wh2_main_sc_hef_high_elves
wh2_main_anc_magic_standard_sacred_banner_of_the_horned_rat	wh2_main_sc_skv_skaven
wh2_main_anc_magic_standard_sea_serpent_standard	wh2_main_sc_def_dark_elves
wh2_main_anc_magic_standard_shroud_of_dripping_death	wh2_main_sc_skv_skaven
wh2_main_anc_magic_standard_skavenpelt_banner	wh2_main_sc_lzd_lizardmen
wh2_main_anc_magic_standard_standard_of_hag_graef	wh2_main_sc_def_dark_elves
wh2_main_anc_magic_standard_storm_banner	wh2_main_sc_skv_skaven
wh2_main_anc_magic_standard_sun_standard_of_chotec	wh2_main_sc_lzd_lizardmen
wh2_main_anc_magic_standard_sunburst_standard_of_hexoatl	wh2_main_sc_lzd_lizardmen
wh2_main_anc_magic_standard_the_blood_banner	wh2_main_sc_def_dark_elves
wh2_main_anc_magic_standard_the_jaguar_standard	wh2_main_sc_lzd_lizardmen
wh2_main_anc_magic_standard_totem_of_prophecy	wh2_main_sc_lzd_lizardmen
wh2_main_anc_mount_def_death_hag_cauldron_of_blood	wh2_main_sc_def_dark_elves
wh2_main_anc_mount_def_dreadlord_black_dragon	wh2_main_sc_def_dark_elves
wh2_main_anc_mount_def_dreadlord_cold_one	wh2_main_sc_def_dark_elves
wh2_main_anc_mount_def_dreadlord_dark_pegasus	wh2_main_sc_def_dark_elves
wh2_main_anc_mount_def_dreadlord_dark_steed	wh2_main_sc_def_dark_elves
wh2_main_anc_mount_def_dreadlord_fem_black_dragon	wh2_main_sc_def_dark_elves
wh2_main_anc_mount_def_dreadlord_fem_cold_one	wh2_main_sc_def_dark_elves
wh2_main_anc_mount_def_dreadlord_fem_dark_pegasus	wh2_main_sc_def_dark_elves
wh2_main_anc_mount_def_dreadlord_fem_dark_steed	wh2_main_sc_def_dark_elves
wh2_main_anc_mount_def_malekith_cold_one_chariot	wh2_main_sc_def_dark_elves
wh2_main_anc_mount_def_malekith_cold_one	wh2_main_sc_def_dark_elves
wh2_main_anc_mount_def_malekith_seraphon	wh2_main_sc_def_dark_elves
wh2_main_anc_mount_def_morathi_sulephet	wh2_main_sc_def_dark_elves
wh2_main_anc_mount_def_sorceress_dark_cold_one	wh2_main_sc_def_dark_elves
wh2_main_anc_mount_def_sorceress_dark_dark_pegasus	wh2_main_sc_def_dark_elves
wh2_main_anc_mount_def_sorceress_dark_dark_steed	wh2_main_sc_def_dark_elves
wh2_main_anc_mount_def_sorceress_fire_cold_one	wh2_main_sc_def_dark_elves
wh2_main_anc_mount_def_sorceress_fire_dark_pegasus	wh2_main_sc_def_dark_elves
wh2_main_anc_mount_def_sorceress_fire_dark_steed	wh2_main_sc_def_dark_elves
wh2_main_anc_mount_def_sorceress_shadow_cold_one	wh2_main_sc_def_dark_elves
wh2_main_anc_mount_def_sorceress_shadow_dark_pegasus	wh2_main_sc_def_dark_elves
wh2_main_anc_mount_def_sorceress_shadow_dark_steed	wh2_main_sc_def_dark_elves
wh2_main_anc_mount_hef_mage_high_elven_steed	wh2_main_sc_hef_high_elves
wh2_main_anc_mount_hef_mage_high_ithilmar_chariot	wh2_main_sc_hef_high_elves
wh2_main_anc_mount_hef_mage_life_elven_steed	wh2_main_sc_hef_high_elves
wh2_main_anc_mount_hef_mage_life_ithilmar_chariot	wh2_main_sc_hef_high_elves
wh2_main_anc_mount_hef_mage_light_elven_steed	wh2_main_sc_hef_high_elves
wh2_main_anc_mount_hef_mage_light_ithilmar_chariot	wh2_main_sc_hef_high_elves
wh2_main_anc_mount_hef_noble_barded_ithilmar_steed	wh2_main_sc_hef_high_elves
wh2_main_anc_mount_hef_noble_eagle	wh2_main_sc_hef_high_elves
wh2_main_anc_mount_hef_noble_ithilmar_chariot	wh2_main_sc_hef_high_elves
wh2_main_anc_mount_hef_prince_barded_ithilmar_steed	wh2_main_sc_hef_high_elves
wh2_main_anc_mount_hef_prince_great_eagle	wh2_main_sc_hef_high_elves
wh2_main_anc_mount_hef_prince_star_dragon	wh2_main_sc_hef_high_elves
wh2_main_anc_mount_hef_prince_sun_dragon	wh2_main_sc_hef_high_elves
wh2_main_anc_mount_hef_tyrion_malhandhir	wh2_main_sc_hef_high_elves
wh2_main_anc_mount_lzd_kroq_gar_cold_one	wh2_main_sc_lzd_lizardmen
wh2_main_anc_mount_lzd_kroq_gar_grymloq	wh2_main_sc_lzd_lizardmen
wh2_main_anc_mount_lzd_kroq_gar_horned_one	wh2_main_sc_lzd_lizardmen
wh2_main_anc_mount_lzd_lord_mazdamundi_zlaaq	wh2_main_sc_lzd_lizardmen
wh2_main_anc_mount_lzd_saurus_old_blood_carnosaur	wh2_main_sc_lzd_lizardmen
wh2_main_anc_mount_lzd_saurus_old_blood_cold_one	wh2_main_sc_lzd_lizardmen
wh2_main_anc_mount_lzd_saurus_scar_veteran_carnosaur	wh2_main_sc_lzd_lizardmen
wh2_main_anc_mount_lzd_saurus_scar_veteran_cold_one	wh2_main_sc_lzd_lizardmen
wh2_main_anc_mount_lzd_skink_chief_ancient_stegadon	wh2_main_sc_lzd_lizardmen
wh2_main_anc_mount_lzd_skink_chief_stegadon	wh2_main_sc_lzd_lizardmen
wh2_main_anc_mount_lzd_skink_chief_terradon	wh2_main_sc_lzd_lizardmen
wh2_main_anc_mount_lzd_skink_priest_beasts_ancient_stegadon	wh2_main_sc_lzd_lizardmen
wh2_main_anc_mount_lzd_skink_priest_beasts_stegadon	wh2_main_sc_lzd_lizardmen
wh2_main_anc_mount_lzd_skink_priest_beasts_terradon	wh2_main_sc_lzd_lizardmen
wh2_main_anc_mount_lzd_skink_priest_heavens_ancient_stegadon	wh2_main_sc_lzd_lizardmen
wh2_main_anc_mount_lzd_skink_priest_heavens_stegadon	wh2_main_sc_lzd_lizardmen
wh2_main_anc_mount_lzd_skink_priest_heavens_terradon	wh2_main_sc_lzd_lizardmen
wh2_main_anc_mount_skv_grey_seer_plague_screaming_bell	wh2_main_sc_skv_skaven
wh2_main_anc_mount_skv_grey_seer_ruin_screaming_bell	wh2_main_sc_skv_skaven
wh2_main_anc_mount_skv_plague_priest_plague_furnace	wh2_main_sc_skv_skaven
wh2_main_anc_mount_skv_warlord_bonebreaker	wh2_main_sc_skv_skaven
wh2_main_anc_talisman_amber_amulet	wh2_main_sc_def_dark_elves
wh2_main_anc_talisman_amulet_of_fire	wh2_main_sc_hef_high_elves
wh2_main_anc_talisman_amulet_of_foresight	wh2_main_sc_hef_high_elves
wh2_main_anc_talisman_amulet_of_itzl	wh2_main_sc_lzd_lizardmen
wh2_main_anc_talisman_aura_of_quetzl	wh2_main_sc_lzd_lizardmen
wh2_main_anc_talisman_crown_of_black_iron	wh2_main_sc_def_dark_elves
wh2_main_anc_talisman_deathmask	wh2_main_sc_def_dark_elves
wh2_main_anc_talisman_diamond_guardian_phoenix	wh2_main_sc_hef_high_elves
wh2_main_anc_talisman_emerald_collar	wh2_main_sc_hef_high_elves
wh2_main_anc_talisman_foul_pendant	wh2_main_sc_skv_skaven
wh2_main_anc_talisman_glyph_necklace	wh2_main_sc_lzd_lizardmen
wh2_main_anc_talisman_golden_crown_of_atrazar	wh2_main_sc_hef_high_elves
wh2_main_anc_talisman_loremasters_cloak	wh2_main_sc_hef_high_elves
wh2_main_anc_talisman_pearl_of_infinite_blackness	wh2_main_sc_def_dark_elves
wh2_main_anc_talisman_ring_of_darkness	wh2_main_sc_def_dark_elves
wh2_main_anc_talisman_ring_of_hotek	wh2_main_sc_def_dark_elves
wh2_main_anc_talisman_rival_hide_talisman	wh2_main_sc_skv_skaven
wh2_main_anc_talisman_ruby_guardian_phoenix	wh2_main_sc_hef_high_elves
wh2_main_anc_talisman_sacred_incense	wh2_main_sc_hef_high_elves
wh2_main_anc_talisman_sapphire_guardian_phoenix	wh2_main_sc_hef_high_elves
wh2_main_anc_talisman_shadow_magnet_trinket	wh2_main_sc_skv_skaven
wh2_main_anc_talisman_talisman_of_saphery	wh2_main_sc_hef_high_elves
wh2_main_anc_talisman_the_black_amulet	wh2_main_sc_def_dark_elves
wh2_main_anc_talisman_vambraces_of_defence	wh2_main_sc_hef_high_elves
wh2_main_anc_weapon_blade_of_bel_korhadris	wh2_main_sc_hef_high_elves
wh2_main_anc_weapon_blade_of_corruption	wh2_main_sc_skv_skaven
wh2_main_anc_weapon_blade_of_darting_steel	wh2_main_sc_hef_high_elves
wh2_main_anc_weapon_blade_of_leaping_gold	wh2_main_sc_hef_high_elves
wh2_main_anc_weapon_blade_of_nurglitch	wh2_main_sc_skv_skaven
wh2_main_anc_weapon_blade_of_revered_tzunki	wh2_main_sc_lzd_lizardmen
wh2_main_anc_weapon_blade_of_ruin	wh2_main_sc_def_dark_elves
wh2_main_anc_weapon_blade_of_sea_gold	wh2_main_sc_hef_high_elves
wh2_main_anc_weapon_bow_of_the_seafarer	wh2_main_sc_hef_high_elves
wh2_main_anc_weapon_burning_blade_of_chotec	wh2_main_sc_lzd_lizardmen
wh2_main_anc_weapon_caledors_bane	wh2_main_sc_def_dark_elves
wh2_main_anc_weapon_chillblade	wh2_main_sc_def_dark_elves
wh2_main_anc_weapon_cobra_mace_of_mazdamundi	wh2_main_sc_lzd_lizardmen
wh2_main_anc_weapon_crimson_death	wh2_main_sc_def_dark_elves
wh2_main_anc_weapon_dagger_of_hotek	wh2_main_sc_def_dark_elves
wh2_main_anc_weapon_dagger_of_sotek	wh2_main_sc_lzd_lizardmen
wh2_main_anc_weapon_deathpiercer	wh2_main_sc_def_dark_elves
wh2_main_anc_weapon_destroyer	wh2_main_sc_def_dark_elves
wh2_main_anc_weapon_dwarf_gouger	wh2_main_sc_skv_skaven
wh2_main_anc_weapon_dwarfbane	wh2_main_sc_skv_skaven
wh2_main_anc_weapon_executioners_axe	wh2_main_sc_def_dark_elves
wh2_main_anc_weapon_foe_bane	wh2_main_sc_hef_high_elves
wh2_main_anc_weapon_heartrender_and_the_darksword	wh2_main_sc_def_dark_elves
wh2_main_anc_weapon_heartseeker	wh2_main_sc_def_dark_elves
wh2_main_anc_weapon_hydra_blade	wh2_main_sc_def_dark_elves
wh2_main_anc_weapon_reaver_bow	wh2_main_sc_hef_high_elves
wh2_main_anc_weapon_revered_spear_of_tlanxla	wh2_main_sc_lzd_lizardmen
wh2_main_anc_weapon_rod_of_corruption	wh2_main_sc_skv_skaven
wh2_main_anc_weapon_scimitar_of_the_sun_resplendent	wh2_main_sc_lzd_lizardmen
wh2_main_anc_weapon_sea_gold_parrying_blade	wh2_main_sc_hef_high_elves
wh2_main_anc_weapon_stegadon_war_spear	wh2_main_sc_lzd_lizardmen
wh2_main_anc_weapon_sunfang	wh2_main_sc_hef_high_elves
wh2_main_anc_weapon_sword_of_teclis	wh2_main_sc_hef_high_elves
wh2_main_anc_weapon_sword_of_the_hornet	wh2_main_sc_lzd_lizardmen
wh2_main_anc_weapon_the_blade_of_realities	wh2_main_sc_lzd_lizardmen
wh2_main_anc_weapon_the_fellblade	wh2_main_sc_skv_skaven
wh2_main_anc_weapon_the_piranha_blade	wh2_main_sc_lzd_lizardmen
wh2_main_anc_weapon_the_star_lance	wh2_main_sc_hef_high_elves
wh2_main_anc_weapon_the_white_sword	wh2_main_sc_hef_high_elves
wh2_main_anc_weapon_venom_sword	wh2_main_sc_def_dark_elves
wh2_main_anc_weapon_warlock_augmented_weapon	wh2_main_sc_skv_skaven
wh2_main_anc_weapon_warpforged_blade	wh2_main_sc_skv_skaven
wh2_main_anc_weapon_web_of_shadows	wh2_main_sc_def_dark_elves
wh2_main_anc_weapon_weeping_blade	wh2_main_sc_skv_skaven
wh2_main_anc_weapon_winged_staff	wh2_main_sc_hef_high_elves
wh_dlc01_anc_follower_chaos_barbarian	wh_dlc03_sc_bst_beastmen
wh_dlc01_anc_follower_chaos_barbarian	wh_main_sc_chs_chaos
wh_dlc01_anc_follower_chaos_barbarian	wh_main_sc_nor_norsca
wh_dlc01_anc_follower_chaos_beast_tamer	wh_dlc03_sc_bst_beastmen
wh_dlc01_anc_follower_chaos_beast_tamer	wh_main_sc_chs_chaos
wh_dlc01_anc_follower_chaos_beast_tamer	wh_main_sc_nor_norsca
wh_dlc01_anc_follower_chaos_collector	wh_dlc03_sc_bst_beastmen
wh_dlc01_anc_follower_chaos_collector	wh_main_sc_chs_chaos
wh_dlc01_anc_follower_chaos_collector	wh_main_sc_nor_norsca
wh_dlc01_anc_follower_chaos_cultist	wh_dlc03_sc_bst_beastmen
wh_dlc01_anc_follower_chaos_cultist	wh_main_sc_chs_chaos
wh_dlc01_anc_follower_chaos_cultist	wh_main_sc_nor_norsca
wh_dlc01_anc_follower_chaos_darksoul	wh_dlc03_sc_bst_beastmen
wh_dlc01_anc_follower_chaos_darksoul	wh_main_sc_chs_chaos
wh_dlc01_anc_follower_chaos_darksoul	wh_main_sc_nor_norsca
wh_dlc01_anc_follower_chaos_demagogue	wh_main_sc_chs_chaos
wh_dlc01_anc_follower_chaos_huscarl	wh_dlc03_sc_bst_beastmen
wh_dlc01_anc_follower_chaos_huscarl	wh_main_sc_chs_chaos
wh_dlc01_anc_follower_chaos_huscarl	wh_main_sc_nor_norsca
wh_dlc01_anc_follower_chaos_kurgan_chieftain	wh_dlc03_sc_bst_beastmen
wh_dlc01_anc_follower_chaos_kurgan_chieftain	wh_main_sc_chs_chaos
wh_dlc01_anc_follower_chaos_kurgan_chieftain	wh_main_sc_nor_norsca
wh_dlc01_anc_follower_chaos_magister	wh_dlc03_sc_bst_beastmen
wh_dlc01_anc_follower_chaos_magister	wh_main_sc_chs_chaos
wh_dlc01_anc_follower_chaos_magister	wh_main_sc_nor_norsca
wh_dlc01_anc_follower_chaos_mutant	wh_dlc03_sc_bst_beastmen
wh_dlc01_anc_follower_chaos_mutant	wh_main_sc_chs_chaos
wh_dlc01_anc_follower_chaos_mutant	wh_main_sc_nor_norsca
wh_dlc01_anc_follower_chaos_oar_slave	wh_dlc03_sc_bst_beastmen
wh_dlc01_anc_follower_chaos_oar_slave	wh_main_sc_chs_chaos
wh_dlc01_anc_follower_chaos_oar_slave	wh_main_sc_nor_norsca
wh_dlc01_anc_follower_chaos_possessed	wh_dlc03_sc_bst_beastmen
wh_dlc01_anc_follower_chaos_possessed	wh_main_sc_chs_chaos
wh_dlc01_anc_follower_chaos_possessed	wh_main_sc_nor_norsca
wh_dlc01_anc_follower_chaos_slave_master	wh_dlc03_sc_bst_beastmen
wh_dlc01_anc_follower_chaos_slave_master	wh_main_sc_chs_chaos
wh_dlc01_anc_follower_chaos_slave_master	wh_main_sc_nor_norsca
wh_dlc01_anc_follower_chaos_zealot	wh_dlc03_sc_bst_beastmen
wh_dlc01_anc_follower_chaos_zealot	wh_main_sc_chs_chaos
wh_dlc01_anc_follower_chaos_zealot	wh_main_sc_nor_norsca
wh_dlc01_anc_mount_chs_chaos_lord_chaos_dragon	wh_main_sc_chs_chaos
wh_dlc01_anc_mount_chs_chaos_lord_manticore	wh_main_sc_chs_chaos
wh_dlc01_anc_mount_chs_chaos_sorcerer_lord_death_barded_chaos_steed	wh_main_sc_chs_chaos
wh_dlc01_anc_mount_chs_chaos_sorcerer_lord_death_chaos_steed	wh_main_sc_chs_chaos
wh_dlc01_anc_mount_chs_chaos_sorcerer_lord_death_dragon	wh_main_sc_chs_chaos
wh_dlc01_anc_mount_chs_chaos_sorcerer_lord_death_manticore	wh_main_sc_chs_chaos
wh_dlc01_anc_mount_chs_chaos_sorcerer_lord_fire_barded_chaos_steed	wh_main_sc_chs_chaos
wh_dlc01_anc_mount_chs_chaos_sorcerer_lord_fire_chaos_steed	wh_main_sc_chs_chaos
wh_dlc01_anc_mount_chs_chaos_sorcerer_lord_fire_dragon	wh_main_sc_chs_chaos
wh_dlc01_anc_mount_chs_chaos_sorcerer_lord_fire_manticore	wh_main_sc_chs_chaos
wh_dlc01_anc_mount_chs_chaos_sorcerer_lord_metal_barded_chaos_steed	wh_main_sc_chs_chaos
wh_dlc01_anc_mount_chs_chaos_sorcerer_lord_metal_chaos_steed	wh_main_sc_chs_chaos
wh_dlc01_anc_mount_chs_chaos_sorcerer_lord_metal_dragon	wh_main_sc_chs_chaos
wh_dlc01_anc_mount_chs_chaos_sorcerer_lord_metal_manticore	wh_main_sc_chs_chaos
wh_dlc01_anc_mount_chs_chaos_sorcerer_lord_shadow_barded_chaos_steed	wh_main_sc_chs_chaos
wh_dlc01_anc_mount_chs_chaos_sorcerer_lord_shadow_chaos_steed	wh_main_sc_chs_chaos
wh_dlc01_anc_mount_chs_chaos_sorcerer_lord_shadow_dragon	wh_main_sc_chs_chaos
wh_dlc01_anc_mount_chs_chaos_sorcerer_lord_shadow_manticore	wh_main_sc_chs_chaos
wh_dlc01_anc_mount_chs_chaos_sorcerer_shadow_barded_chaos_steed	wh_main_sc_chs_chaos
wh_dlc01_anc_mount_chs_chaos_sorcerer_shadow_chaos_steed	wh_main_sc_chs_chaos
wh_dlc01_anc_mount_chs_chaos_sorcerer_shadow_manticore	wh_main_sc_chs_chaos
wh_dlc01_anc_mount_chs_exalted_hero_manticore	wh_main_sc_chs_chaos
wh_dlc01_anc_mount_nor_chaos_sorcerer_lord_warhorse	wh_main_sc_nor_norsca
wh_dlc03_anc_arcane_item_hagtree_fetish	wh_dlc03_sc_bst_beastmen
wh_dlc03_anc_arcane_item_jagged_dagger	wh_dlc03_sc_bst_beastmen
wh_dlc03_anc_arcane_item_skull_of_rarkos	wh_dlc03_sc_bst_beastmen
wh_dlc03_anc_arcane_item_staff_of_darkoth	wh_dlc03_sc_bst_beastmen
wh_dlc03_anc_armour_blackened_plate	wh_dlc03_sc_bst_beastmen
wh_dlc03_anc_armour_pelt_of_the_shadowgave	wh_dlc03_sc_bst_beastmen
wh_dlc03_anc_armour_ramhorn_helm	wh_dlc03_sc_bst_beastmen
wh_dlc03_anc_armour_the_dark_mail	wh_dlc03_sc_bst_beastmen
wh_dlc03_anc_armour_trollhide	wh_dlc03_sc_bst_beastmen
wh_dlc03_anc_enchanted_item_horn_of_the_first_beast	wh_dlc03_sc_bst_beastmen
wh_dlc03_anc_enchanted_item_shard_of_the_herdstone	wh_dlc03_sc_bst_beastmen
wh_dlc03_anc_follower_beastmen_bray_shamans_familiar	wh_dlc03_sc_bst_beastmen
wh_dlc03_anc_follower_beastmen_chieftains_pet	wh_dlc03_sc_bst_beastmen
wh_dlc03_anc_follower_beastmen_doe	wh_dlc03_sc_bst_beastmen
wh_dlc03_anc_follower_beastmen_flayer	wh_dlc03_sc_bst_beastmen
wh_dlc03_anc_follower_beastmen_flying_spy	wh_dlc03_sc_bst_beastmen
wh_dlc03_anc_follower_beastmen_herdstone_keeper	wh_dlc03_sc_bst_beastmen
wh_dlc03_anc_follower_beastmen_mannish_thrall	wh_dlc03_sc_bst_beastmen
wh_dlc03_anc_follower_beastmen_pox_carrier	wh_dlc03_sc_bst_beastmen
wh_dlc03_anc_follower_beastmen_spawn_wrangler	wh_dlc03_sc_bst_beastmen
wh_dlc03_anc_follower_beastmen_ungor_whelp	wh_dlc03_sc_bst_beastmen
wh_dlc03_anc_magic_standard_banner_of_outrage	wh_dlc03_sc_bst_beastmen
wh_dlc03_anc_magic_standard_banner_of_the_fallen_kings	wh_dlc03_sc_bst_beastmen
wh_dlc03_anc_magic_standard_manbane_standard	wh_dlc03_sc_bst_beastmen
wh_dlc03_anc_magic_standard_the_beast_banner	wh_dlc03_sc_bst_beastmen
wh_dlc03_anc_magic_standard_totem_of_rust	wh_dlc03_sc_bst_beastmen
wh_dlc03_anc_mark_of_chaos_crown_of_horns	wh_dlc03_sc_bst_beastmen
wh_dlc03_anc_mark_of_chaos_gnarled_hide	wh_dlc03_sc_bst_beastmen
wh_dlc03_anc_mark_of_chaos_gouge_tusks	wh_dlc03_sc_bst_beastmen
wh_dlc03_anc_mark_of_chaos_many_limbed_fiend	wh_dlc03_sc_bst_beastmen
wh_dlc03_anc_mark_of_chaos_shadow_hide	wh_dlc03_sc_bst_beastmen
wh_dlc03_anc_mark_of_chaos_slug_skin	wh_dlc03_sc_bst_beastmen
wh_dlc03_anc_mark_of_chaos_uncanny_senses	wh_dlc03_sc_bst_beastmen
wh_dlc03_anc_talisman_chalice_of_dark_rain	wh_dlc03_sc_bst_beastmen
wh_dlc03_anc_talisman_icon_of_vilification	wh_dlc03_sc_bst_beastmen
wh_dlc03_anc_weapon_axe_of_men	wh_dlc03_sc_bst_beastmen
wh_dlc03_anc_weapon_axes_of_khorgor	wh_dlc03_sc_bst_beastmen
wh_dlc03_anc_weapon_everbleed	wh_dlc03_sc_bst_beastmen
wh_dlc03_anc_weapon_hunting_spear	wh_dlc03_sc_bst_beastmen
wh_dlc03_anc_weapon_mangelder	wh_dlc03_sc_bst_beastmen
wh_dlc03_anc_weapon_primeval_club	wh_dlc03_sc_bst_beastmen
wh_dlc03_anc_weapon_scourge	wh_dlc03_sc_bst_beastmen
wh_dlc03_anc_weapon_stonecrusher_mace	wh_dlc03_sc_bst_beastmen
wh_dlc03_anc_weapon_the_steel_claws	wh_dlc03_sc_bst_beastmen
wh_dlc03_bst_cha_beastlord_1	wh_dlc03_sc_bst_beastmen
wh_dlc03_bst_cha_bray_shaman_beasts_1	wh_dlc03_sc_bst_beastmen
wh_dlc03_bst_cha_bray_shaman_death_1	wh_dlc03_sc_bst_beastmen
wh_dlc03_bst_cha_bray_shaman_wild_1	wh_dlc03_sc_bst_beastmen
wh_dlc03_bst_cha_khazrak_one_eye_1	wh_dlc03_sc_bst_beastmen
wh_dlc04_anc_arcane_item_the_liber_noctus	wh_main_sc_vmp_vampire_counts
wh_dlc04_anc_mount_emp_volkmar_the_grim_altar_of_sigmar	wh_main_sc_emp_empire
wh_dlc04_anc_mount_vmp_helman_ghorst_corpse_cart	wh_main_sc_vmp_vampire_counts
wh_dlc04_anc_mount_vmp_master_necromancer_corpse_cart_balefire	wh_main_sc_vmp_vampire_counts
wh_dlc04_anc_mount_vmp_master_necromancer_corpse_cart_unholy_lodestone	wh_main_sc_vmp_vampire_counts
wh_dlc04_anc_mount_vmp_master_necromancer_corpse_cart	wh_main_sc_vmp_vampire_counts
wh_dlc04_anc_mount_vmp_necromancer_corpse_cart_balefire	wh_main_sc_vmp_vampire_counts
wh_dlc04_anc_mount_vmp_necromancer_corpse_cart_unholy_lodestone	wh_main_sc_vmp_vampire_counts
wh_dlc04_anc_mount_vmp_necromancer_corpse_cart	wh_main_sc_vmp_vampire_counts
wh_dlc04_anc_talisman_jade_griffon	wh_main_sc_emp_empire
wh_dlc04_anc_talisman_the_carstein_ring	wh_main_sc_vmp_vampire_counts
wh_dlc04_anc_weapon_blood_drinker	wh_main_sc_vmp_vampire_counts
wh_dlc04_anc_weapon_staff_of_command	wh_main_sc_emp_empire
wh_dlc05_anc_armour_the_helm_of_the_hunt	wh_dlc05_sc_wef_wood_elves
wh_dlc05_anc_enchanted_item_hail_of_doom_arrow	wh_dlc05_sc_wef_wood_elves
wh_dlc05_anc_enchanted_item_horn_of_the_wild_hunt	wh_dlc05_sc_wef_wood_elves
wh_dlc05_anc_follower_dryad_spy	wh_dlc05_sc_wef_wood_elves
wh_dlc05_anc_follower_elder_scout	wh_dlc05_sc_wef_wood_elves
wh_dlc05_anc_follower_eternal_guard_commander	wh_dlc05_sc_wef_wood_elves
wh_dlc05_anc_follower_forest_spirit	wh_dlc05_sc_wef_wood_elves
wh_dlc05_anc_follower_hawk_companion	wh_dlc05_sc_wef_wood_elves
wh_dlc05_anc_follower_hunting_hound	wh_dlc05_sc_wef_wood_elves
wh_dlc05_anc_follower_royal_standard_bearer	wh_dlc05_sc_wef_wood_elves
wh_dlc05_anc_follower_vauls_anvil_smith	wh_dlc05_sc_wef_wood_elves
wh_dlc05_anc_follower_wardancer_drummer	wh_dlc05_sc_wef_wood_elves
wh_dlc05_anc_follower_young_stag	wh_dlc05_sc_wef_wood_elves
wh_dlc05_anc_magic_standard_the_banner_of_the_eternal_queen	wh_dlc05_sc_wef_wood_elves
wh_dlc05_anc_magic_standard_the_banner_of_the_hunter_king	wh_dlc05_sc_wef_wood_elves
wh_dlc05_anc_mount_emp_grey_wizard_barded_warhorse	wh_main_sc_emp_empire
wh_dlc05_anc_mount_emp_grey_wizard_imperial_pegasus	wh_main_sc_emp_empire
wh_dlc05_anc_mount_emp_grey_wizard_warhorse	wh_main_sc_emp_empire
wh_dlc05_anc_mount_emp_jade_wizard_barded_warhorse	wh_main_sc_emp_empire
wh_dlc05_anc_mount_emp_jade_wizard_imperial_pegasus	wh_main_sc_emp_empire
wh_dlc05_anc_mount_emp_jade_wizard_warhorse	wh_main_sc_emp_empire
wh_dlc05_anc_mount_vmp_vampire_shadow_barded_nightmare	wh_main_sc_vmp_vampire_counts
wh_dlc05_anc_mount_vmp_vampire_shadow_hellsteed	wh_main_sc_vmp_vampire_counts
wh_dlc05_anc_mount_wef_glade_lord_elven_steed_fem	wh_dlc05_sc_wef_wood_elves
wh_dlc05_anc_mount_wef_glade_lord_elven_steed	wh_dlc05_sc_wef_wood_elves
wh_dlc05_anc_mount_wef_glade_lord_forest_dragon_fem	wh_dlc05_sc_wef_wood_elves
wh_dlc05_anc_mount_wef_glade_lord_forest_dragon	wh_dlc05_sc_wef_wood_elves
wh_dlc05_anc_mount_wef_glade_lord_great_eagle_fem	wh_dlc05_sc_wef_wood_elves
wh_dlc05_anc_mount_wef_glade_lord_great_eagle	wh_dlc05_sc_wef_wood_elves
wh_dlc05_anc_mount_wef_spellsinger_beast_elven_steed	wh_dlc05_sc_wef_wood_elves
wh_dlc05_anc_mount_wef_spellsinger_beast_great_eagle	wh_dlc05_sc_wef_wood_elves
wh_dlc05_anc_mount_wef_spellsinger_beast_unicorn	wh_dlc05_sc_wef_wood_elves
wh_dlc05_anc_mount_wef_spellsinger_life_elven_steed	wh_dlc05_sc_wef_wood_elves
wh_dlc05_anc_mount_wef_spellsinger_life_great_eagle	wh_dlc05_sc_wef_wood_elves
wh_dlc05_anc_mount_wef_spellsinger_life_unicorn	wh_dlc05_sc_wef_wood_elves
wh_dlc05_anc_mount_wef_spellsinger_shadow_elven_steed	wh_dlc05_sc_wef_wood_elves
wh_dlc05_anc_mount_wef_spellsinger_shadow_great_eagle	wh_dlc05_sc_wef_wood_elves
wh_dlc05_anc_mount_wef_spellsinger_shadow_unicorn	wh_dlc05_sc_wef_wood_elves
wh_dlc05_anc_talisman_cloak_of_isha	wh_dlc05_sc_wef_wood_elves
wh_dlc05_anc_weapon_daiths_reaper	wh_dlc05_sc_wef_wood_elves
wh_dlc05_anc_weapon_daiths_sword	wh_dlc05_sc_wef_wood_elves
wh_dlc05_anc_weapon_spear_of_kurnous	wh_dlc05_sc_wef_wood_elves
wh_dlc05_anc_weapon_the_bow_of_loren	wh_dlc05_sc_wef_wood_elves
wh_dlc05_anc_weapon_the_spirit_sword	wh_dlc05_sc_wef_wood_elves
wh_dlc06_anc_arcane_item_squiggly_beast	wh_main_sc_grn_greenskins
wh_dlc06_anc_arcane_item_squiggly_beast	wh_main_sc_vmp_vampire_counts
wh_dlc06_anc_armour_shield_of_defiance	wh_main_sc_dwf_dwarfs
wh_dlc06_anc_enchanted_item_baleful_mask	wh_main_sc_grn_greenskins
wh_dlc06_anc_magic_standard_skarsniks_boyz	wh_main_sc_grn_greenskins
wh_dlc06_anc_mount_dwf_runelord_anvil_of_doom	wh_main_sc_dwf_dwarfs
wh_dlc06_anc_mount_grn_night_goblin_warboss_great_cave_squig	wh_main_sc_grn_greenskins
wh_dlc06_anc_mount_grn_wurrzag_spleenrippa	wh_main_sc_grn_greenskins
wh_dlc06_anc_rune_rune_of_fury	wh_main_sc_dwf_dwarfs
wh_dlc06_anc_rune_rune_of_might	wh_main_sc_dwf_dwarfs
wh_dlc06_anc_rune_rune_of_parrying	wh_main_sc_dwf_dwarfs
wh_dlc06_anc_rune_rune_of_striking	wh_main_sc_dwf_dwarfs
wh_dlc06_anc_weapon_bonewood_staff	wh_main_sc_grn_greenskins
wh_dlc06_anc_weapon_skarsniks_prodder	wh_main_sc_grn_greenskins
wh_dlc06_anc_weapon_the_hammer_of_angrund	wh_main_sc_dwf_dwarfs
wh_dlc07_anc_arcane_item_the_chalice_of_potions	wh_main_sc_brt_bretonnia
wh_dlc07_anc_armour_armour_of_the_midsummer_sun	wh_main_sc_brt_bretonnia
wh_dlc07_anc_armour_cuirass_of_fortune	wh_main_sc_brt_bretonnia
wh_dlc07_anc_armour_gilded_cuirass	wh_main_sc_brt_bretonnia
wh_dlc07_anc_armour_the_grail_shield	wh_main_sc_brt_bretonnia
wh_dlc07_anc_enchanted_item_holy_icon	wh_main_sc_brt_bretonnia
wh_dlc07_anc_enchanted_item_mane_of_the_purebreed	wh_main_sc_brt_bretonnia
wh_dlc07_anc_enchanted_item_sacrament_of_the_lady	wh_main_sc_brt_bretonnia
wh_dlc07_anc_magic_standard_banner_of_defence	wh_main_sc_brt_bretonnia
wh_dlc07_anc_magic_standard_errantry_banner	wh_main_sc_brt_bretonnia
wh_dlc07_anc_magic_standard_twilight_banner	wh_main_sc_brt_bretonnia
wh_dlc07_anc_magic_standard_valorous_standard	wh_main_sc_brt_bretonnia
wh_dlc07_anc_mount_brt_alberic_barbed_warhorse	wh_main_sc_brt_bretonnia
wh_dlc07_anc_mount_brt_alberic_royal_hipppogryph	wh_main_sc_brt_bretonnia
wh_dlc07_anc_mount_brt_alberic_royal_pegasus	wh_main_sc_brt_bretonnia
wh_dlc07_anc_mount_brt_fay_enchantress_silvaron	wh_main_sc_brt_bretonnia
wh_dlc07_anc_mount_brt_prophetess_brettonian_warhorse	wh_main_sc_brt_bretonnia
wh_dlc07_anc_mount_brt_prophetess_royal_pegasus	wh_main_sc_brt_bretonnia
wh_dlc07_anc_talisman_dragons_claw	wh_main_sc_brt_bretonnia
wh_dlc07_anc_talisman_siriennes_locket	wh_main_sc_brt_bretonnia
wh_dlc07_anc_weapon_sword_of_the_ladys_champion	wh_main_sc_brt_bretonnia
wh_dlc07_anc_weapon_sword_of_the_quest	wh_main_sc_brt_bretonnia
wh_dlc07_anc_weapon_the_silver_lance_of_the_blessed	wh_main_sc_brt_bretonnia
wh_dlc07_anc_weapon_the_wyrmlance	wh_main_sc_brt_bretonnia
wh_dlc07_anc_weapon_trident_of_manann	wh_main_sc_brt_bretonnia
wh_main_anc_arcane_item_black_periapt	wh_main_sc_vmp_vampire_counts
wh_main_anc_arcane_item_book_of_arkhan	wh_main_sc_vmp_vampire_counts
wh_main_anc_arcane_item_lucky_shrunken_head	wh_main_sc_grn_greenskins
wh_main_anc_arcane_item_lucky_shrunken_head	wh_main_sc_grn_savage_orcs
wh_main_anc_arcane_item_skull_of_katam	wh_dlc03_sc_bst_beastmen
wh_main_anc_arcane_item_skull_of_katam	wh_main_sc_chs_chaos
wh_main_anc_arcane_item_skull_staff	wh_main_sc_vmp_vampire_counts
wh_main_anc_arcane_item_staff_of_damnation	wh_main_sc_vmp_vampire_counts
wh_main_anc_arcane_item_staff_of_volans	wh_main_sc_emp_empire
wh_main_anc_armour_armour_of_gork	wh_main_sc_grn_greenskins
wh_main_anc_armour_armour_of_gork	wh_main_sc_grn_savage_orcs
wh_main_anc_armour_armour_of_templehof	wh_main_sc_vmp_vampire_counts
wh_main_anc_armour_auric_armour	wh_main_sc_chs_chaos
wh_main_anc_armour_azhags_ard_armour	wh_main_sc_grn_greenskins
wh_main_anc_armour_blood-forged_armour	wh_main_sc_grn_greenskins
wh_main_anc_armour_helm_of_many_eyes	wh_dlc03_sc_bst_beastmen
wh_main_anc_armour_helm_of_many_eyes	wh_main_sc_chs_chaos
wh_main_anc_armour_magnificent_armour_of_borek_beetlebrow	wh_main_sc_dwf_dwarfs
wh_main_anc_armour_nightshroud	wh_main_sc_vmp_vampire_counts
wh_main_anc_armour_the_armour_of_meteoric_iron	wh_main_sc_emp_empire
wh_main_anc_armour_the_armour_of_meteoric_iron	wh_main_sc_ksl_kislev
wh_main_anc_armour_the_armour_of_meteoric_iron	wh_main_sc_teb_teb
wh_main_anc_armour_the_armour_of_morkar	wh_main_sc_chs_chaos
wh_main_anc_armour_the_armour_of_skaldour	wh_main_sc_dwf_dwarfs
wh_main_anc_armour_the_lions_shield	wh_main_sc_brt_bretonnia
wh_main_anc_armour_the_slayer_crown	wh_main_sc_dwf_dwarfs
wh_main_anc_enchanted_item_chalice_of_chaos	wh_dlc03_sc_bst_beastmen
wh_main_anc_enchanted_item_chalice_of_chaos	wh_main_sc_chs_chaos
wh_main_anc_enchanted_item_cloak_of_mists_and_shadows	wh_main_sc_vmp_vampire_counts
wh_main_anc_enchanted_item_cloak_of_molten_metal	wh_main_sc_emp_empire
wh_main_anc_enchanted_item_fiery_ring_of_thori	wh_main_sc_dwf_dwarfs
wh_main_anc_enchanted_item_pendant_of_slaanesh	wh_dlc03_sc_bst_beastmen
wh_main_anc_enchanted_item_pendant_of_slaanesh	wh_main_sc_chs_chaos
wh_main_anc_enchanted_item_rod_of_flaming_death	wh_main_sc_vmp_vampire_counts
wh_main_anc_enchanted_item_silver_horn_of_vengeance	wh_main_sc_dwf_dwarfs
wh_main_anc_enchanted_item_skull_wand_of_kaloth	wh2_main_sc_hef_high_elves
wh_main_anc_enchanted_item_skull_wand_of_kaloth	wh_main_sc_grn_greenskins
wh_main_anc_enchanted_item_skull_wand_of_kaloth	wh_main_sc_grn_savage_orcs
wh_main_anc_enchanted_item_the_crown_of_bretonnia	wh_main_sc_brt_bretonnia
wh_main_anc_enchanted_item_the_crown_of_domination	wh_main_sc_chs_chaos
wh_main_anc_enchanted_item_the_crown_of_sorcery	wh_main_sc_grn_greenskins
wh_main_anc_enchanted_item_the_great_book_of_grudges	wh_main_sc_dwf_dwarfs
wh_main_anc_enchanted_item_van_horstmanns_speculum	wh_main_sc_emp_empire
wh_main_anc_enchanted_item_van_horstmanns_speculum	wh_main_sc_ksl_kislev
wh_main_anc_enchanted_item_van_horstmanns_speculum	wh_main_sc_teb_teb
wh_main_anc_follower_all_hedge_wizard	wh_main_sc_brt_bretonnia
wh_main_anc_follower_all_hedge_wizard	wh_main_sc_emp_empire
wh_main_anc_follower_all_hedge_wizard	wh_main_sc_ksl_kislev
wh_main_anc_follower_all_hedge_wizard	wh_main_sc_teb_teb
wh_main_anc_follower_all_men_bailiff	wh_main_sc_brt_bretonnia
wh_main_anc_follower_all_men_bailiff	wh_main_sc_emp_empire
wh_main_anc_follower_all_men_bailiff	wh_main_sc_ksl_kislev
wh_main_anc_follower_all_men_bailiff	wh_main_sc_teb_teb
wh_main_anc_follower_all_men_boatman	wh_main_sc_brt_bretonnia
wh_main_anc_follower_all_men_boatman	wh_main_sc_emp_empire
wh_main_anc_follower_all_men_boatman	wh_main_sc_ksl_kislev
wh_main_anc_follower_all_men_boatman	wh_main_sc_teb_teb
wh_main_anc_follower_all_men_bodyguard	wh_main_sc_brt_bretonnia
wh_main_anc_follower_all_men_bodyguard	wh_main_sc_emp_empire
wh_main_anc_follower_all_men_bodyguard	wh_main_sc_ksl_kislev
wh_main_anc_follower_all_men_bodyguard	wh_main_sc_teb_teb
wh_main_anc_follower_all_men_bounty_hunter	wh_main_sc_brt_bretonnia
wh_main_anc_follower_all_men_bounty_hunter	wh_main_sc_emp_empire
wh_main_anc_follower_all_men_bounty_hunter	wh_main_sc_ksl_kislev
wh_main_anc_follower_all_men_bounty_hunter	wh_main_sc_teb_teb
wh_main_anc_follower_all_men_fisherman	wh_main_sc_emp_empire
wh_main_anc_follower_all_men_grave_robber	wh_main_sc_brt_bretonnia
wh_main_anc_follower_all_men_grave_robber	wh_main_sc_emp_empire
wh_main_anc_follower_all_men_grave_robber	wh_main_sc_ksl_kislev
wh_main_anc_follower_all_men_grave_robber	wh_main_sc_teb_teb
wh_main_anc_follower_all_men_initiate	wh_main_sc_brt_bretonnia
wh_main_anc_follower_all_men_initiate	wh_main_sc_emp_empire
wh_main_anc_follower_all_men_initiate	wh_main_sc_ksl_kislev
wh_main_anc_follower_all_men_initiate	wh_main_sc_teb_teb
wh_main_anc_follower_all_men_kislevite_kossar	wh_main_sc_brt_bretonnia
wh_main_anc_follower_all_men_kislevite_kossar	wh_main_sc_emp_empire
wh_main_anc_follower_all_men_kislevite_kossar	wh_main_sc_ksl_kislev
wh_main_anc_follower_all_men_kislevite_kossar	wh_main_sc_teb_teb
wh_main_anc_follower_all_men_mercenary	wh_main_sc_brt_bretonnia
wh_main_anc_follower_all_men_mercenary	wh_main_sc_emp_empire
wh_main_anc_follower_all_men_mercenary	wh_main_sc_ksl_kislev
wh_main_anc_follower_all_men_mercenary	wh_main_sc_teb_teb
wh_main_anc_follower_all_men_militiaman	wh_main_sc_brt_bretonnia
wh_main_anc_follower_all_men_militiaman	wh_main_sc_emp_empire
wh_main_anc_follower_all_men_militiaman	wh_main_sc_ksl_kislev
wh_main_anc_follower_all_men_militiaman	wh_main_sc_teb_teb
wh_main_anc_follower_all_men_ogres_pit_fighter	wh_main_sc_brt_bretonnia
wh_main_anc_follower_all_men_ogres_pit_fighter	wh_main_sc_emp_empire
wh_main_anc_follower_all_men_ogres_pit_fighter	wh_main_sc_ksl_kislev
wh_main_anc_follower_all_men_ogres_pit_fighter	wh_main_sc_teb_teb
wh_main_anc_follower_all_men_outlaw	wh_main_sc_brt_bretonnia
wh_main_anc_follower_all_men_outlaw	wh_main_sc_emp_empire
wh_main_anc_follower_all_men_outlaw	wh_main_sc_ksl_kislev
wh_main_anc_follower_all_men_outlaw	wh_main_sc_teb_teb
wh_main_anc_follower_all_men_outrider	wh_main_sc_emp_empire
wh_main_anc_follower_all_men_protagonist	wh_main_sc_brt_bretonnia
wh_main_anc_follower_all_men_protagonist	wh_main_sc_emp_empire
wh_main_anc_follower_all_men_protagonist	wh_main_sc_ksl_kislev
wh_main_anc_follower_all_men_protagonist	wh_main_sc_teb_teb
wh_main_anc_follower_all_men_rogue	wh_main_sc_brt_bretonnia
wh_main_anc_follower_all_men_rogue	wh_main_sc_emp_empire
wh_main_anc_follower_all_men_rogue	wh_main_sc_ksl_kislev
wh_main_anc_follower_all_men_rogue	wh_main_sc_teb_teb
wh_main_anc_follower_all_men_servant	wh_main_sc_brt_bretonnia
wh_main_anc_follower_all_men_servant	wh_main_sc_emp_empire
wh_main_anc_follower_all_men_servant	wh_main_sc_ksl_kislev
wh_main_anc_follower_all_men_servant	wh_main_sc_teb_teb
wh_main_anc_follower_all_men_smuggler	wh_main_sc_brt_bretonnia
wh_main_anc_follower_all_men_smuggler	wh_main_sc_emp_empire
wh_main_anc_follower_all_men_smuggler	wh_main_sc_ksl_kislev
wh_main_anc_follower_all_men_smuggler	wh_main_sc_teb_teb
wh_main_anc_follower_all_men_soldier	wh_main_sc_brt_bretonnia
wh_main_anc_follower_all_men_soldier	wh_main_sc_emp_empire
wh_main_anc_follower_all_men_soldier	wh_main_sc_ksl_kislev
wh_main_anc_follower_all_men_soldier	wh_main_sc_teb_teb
wh_main_anc_follower_all_men_thug	wh_main_sc_brt_bretonnia
wh_main_anc_follower_all_men_thug	wh_main_sc_emp_empire
wh_main_anc_follower_all_men_thug	wh_main_sc_ksl_kislev
wh_main_anc_follower_all_men_thug	wh_main_sc_teb_teb
wh_main_anc_follower_all_men_tollkeeper	wh_main_sc_brt_bretonnia
wh_main_anc_follower_all_men_tollkeeper	wh_main_sc_emp_empire
wh_main_anc_follower_all_men_tollkeeper	wh_main_sc_ksl_kislev
wh_main_anc_follower_all_men_tollkeeper	wh_main_sc_teb_teb
wh_main_anc_follower_all_men_tomb_robber	wh_main_sc_brt_bretonnia
wh_main_anc_follower_all_men_tomb_robber	wh_main_sc_emp_empire
wh_main_anc_follower_all_men_tomb_robber	wh_main_sc_ksl_kislev
wh_main_anc_follower_all_men_tomb_robber	wh_main_sc_teb_teb
wh_main_anc_follower_all_men_vagabond	wh_main_sc_brt_bretonnia
wh_main_anc_follower_all_men_vagabond	wh_main_sc_emp_empire
wh_main_anc_follower_all_men_vagabond	wh_main_sc_ksl_kislev
wh_main_anc_follower_all_men_vagabond	wh_main_sc_teb_teb
wh_main_anc_follower_all_men_valet	wh_main_sc_brt_bretonnia
wh_main_anc_follower_all_men_valet	wh_main_sc_emp_empire
wh_main_anc_follower_all_men_valet	wh_main_sc_ksl_kislev
wh_main_anc_follower_all_men_valet	wh_main_sc_teb_teb
wh_main_anc_follower_all_men_zealot	wh_main_sc_brt_bretonnia
wh_main_anc_follower_all_men_zealot	wh_main_sc_emp_empire
wh_main_anc_follower_all_men_zealot	wh_main_sc_ksl_kislev
wh_main_anc_follower_all_men_zealot	wh_main_sc_teb_teb
wh_main_anc_follower_all_student	wh_main_sc_brt_bretonnia
wh_main_anc_follower_all_student	wh_main_sc_chs_chaos
wh_main_anc_follower_all_student	wh_main_sc_dwf_dwarfs
wh_main_anc_follower_all_student	wh_main_sc_emp_empire
wh_main_anc_follower_all_student	wh_main_sc_ksl_kislev
wh_main_anc_follower_all_student	wh_main_sc_nor_norsca
wh_main_anc_follower_all_student	wh_main_sc_teb_teb
wh_main_anc_follower_all_student	wh_main_sc_vmp_vampire_counts
wh_main_anc_follower_bretonnia_court_jester	wh_main_sc_brt_bretonnia
wh_main_anc_follower_bretonnia_squire	wh_main_sc_brt_bretonnia
wh_main_anc_follower_dwarfs_archivist	wh_main_sc_dwf_dwarfs
wh_main_anc_follower_dwarfs_brewmaster	wh_main_sc_dwf_dwarfs
wh_main_anc_follower_dwarfs_candle_maker	wh_main_sc_dwf_dwarfs
wh_main_anc_follower_dwarfs_choir_master	wh_main_sc_dwf_dwarfs
wh_main_anc_follower_dwarfs_cooper	wh_main_sc_dwf_dwarfs
wh_main_anc_follower_dwarfs_daughter_of_valaya	wh_main_sc_dwf_dwarfs
wh_main_anc_follower_dwarfs_dwarf_bride	wh_main_sc_dwf_dwarfs
wh_main_anc_follower_dwarfs_dwarfen_tattooist	wh_main_sc_dwf_dwarfs
wh_main_anc_follower_dwarfs_goldsmith	wh_main_sc_dwf_dwarfs
wh_main_anc_follower_dwarfs_grudgekeeper	wh_main_sc_dwf_dwarfs
wh_main_anc_follower_dwarfs_guildmaster	wh_main_sc_dwf_dwarfs
wh_main_anc_follower_dwarfs_jewelsmith	wh_main_sc_dwf_dwarfs
wh_main_anc_follower_dwarfs_miner	wh_main_sc_dwf_dwarfs
wh_main_anc_follower_dwarfs_powder_mixer	wh_main_sc_dwf_dwarfs
wh_main_anc_follower_dwarfs_prospector	wh_main_sc_dwf_dwarfs
wh_main_anc_follower_dwarfs_reckoner	wh_main_sc_dwf_dwarfs
wh_main_anc_follower_dwarfs_runebearer	wh_main_sc_dwf_dwarfs
wh_main_anc_follower_dwarfs_runesmith_apprentice	wh_main_sc_dwf_dwarfs
wh_main_anc_follower_dwarfs_sapper	wh_main_sc_dwf_dwarfs
wh_main_anc_follower_dwarfs_shieldbreaker	wh_main_sc_dwf_dwarfs
wh_main_anc_follower_dwarfs_shipwright	wh_main_sc_dwf_dwarfs
wh_main_anc_follower_dwarfs_slayer_ward	wh_main_sc_dwf_dwarfs
wh_main_anc_follower_dwarfs_stonemason	wh_main_sc_dwf_dwarfs
wh_main_anc_follower_dwarfs_teller_of_tales	wh_main_sc_dwf_dwarfs
wh_main_anc_follower_dwarfs_treasure_hunter	wh_main_sc_dwf_dwarfs
wh_main_anc_follower_dwarfs_troll_slayer	wh_main_sc_dwf_dwarfs
wh_main_anc_follower_empire_agitator	wh_main_sc_emp_empire
wh_main_anc_follower_empire_apprentice_wizard	wh_main_sc_emp_empire
wh_main_anc_follower_empire_barber_surgeon	wh_main_sc_emp_empire
wh_main_anc_follower_empire_bone_picker	wh_main_sc_emp_empire
wh_main_anc_follower_empire_burgher	wh_main_sc_emp_empire
wh_main_anc_follower_empire_camp_follower	wh_main_sc_emp_empire
wh_main_anc_follower_empire_charcoal_burner	wh_main_sc_emp_empire
wh_main_anc_follower_empire_coachman	wh_main_sc_emp_empire
wh_main_anc_follower_empire_entertainer	wh_main_sc_emp_empire
wh_main_anc_follower_empire_estalian_diestro	wh_main_sc_brt_bretonnia
wh_main_anc_follower_empire_estalian_diestro	wh_main_sc_emp_empire
wh_main_anc_follower_empire_estalian_diestro	wh_main_sc_ksl_kislev
wh_main_anc_follower_empire_estalian_diestro	wh_main_sc_teb_teb
wh_main_anc_follower_empire_ferryman	wh_main_sc_emp_empire
wh_main_anc_follower_empire_hunter	wh_main_sc_emp_empire
wh_main_anc_follower_empire_jailer	wh_main_sc_emp_empire
wh_main_anc_follower_empire_light_college_acolyte	wh_main_sc_emp_empire
wh_main_anc_follower_empire_marine	wh_main_sc_emp_empire
wh_main_anc_follower_empire_messenger	wh_main_sc_emp_empire
wh_main_anc_follower_empire_noble	wh_main_sc_emp_empire
wh_main_anc_follower_empire_peasant	wh_main_sc_emp_empire
wh_main_anc_follower_empire_rat_catcher	wh_main_sc_emp_empire
wh_main_anc_follower_empire_road_warden	wh_main_sc_emp_empire
wh_main_anc_follower_empire_scribe	wh_main_sc_emp_empire
wh_main_anc_follower_empire_seaman	wh_main_sc_emp_empire
wh_main_anc_follower_empire_thief	wh_main_sc_emp_empire
wh_main_anc_follower_empire_tradesman	wh_main_sc_emp_empire
wh_main_anc_follower_empire_watchman	wh_main_sc_emp_empire
wh_main_anc_follower_empire_woodsman	wh_main_sc_emp_empire
wh_main_anc_follower_greenskins_backstabba	wh_main_sc_grn_greenskins
wh_main_anc_follower_greenskins_backstabba	wh_main_sc_grn_savage_orcs
wh_main_anc_follower_greenskins_bat-winged_loony	wh_main_sc_grn_greenskins
wh_main_anc_follower_greenskins_bat-winged_loony	wh_main_sc_grn_savage_orcs
wh_main_anc_follower_greenskins_boggart	wh_main_sc_grn_greenskins
wh_main_anc_follower_greenskins_boggart	wh_main_sc_grn_savage_orcs
wh_main_anc_follower_greenskins_bully	wh_main_sc_grn_greenskins
wh_main_anc_follower_greenskins_bully	wh_main_sc_grn_savage_orcs
wh_main_anc_follower_greenskins_dog_boy_scout	wh_main_sc_grn_greenskins
wh_main_anc_follower_greenskins_dog_boy_scout	wh_main_sc_grn_savage_orcs
wh_main_anc_follower_greenskins_dung_collector	wh_main_sc_grn_greenskins
wh_main_anc_follower_greenskins_dung_collector	wh_main_sc_grn_savage_orcs
wh_main_anc_follower_greenskins_gobbo_ranta	wh_main_sc_grn_greenskins
wh_main_anc_follower_greenskins_gobbo_ranta	wh_main_sc_grn_savage_orcs
wh_main_anc_follower_greenskins_idol_carva	wh_main_sc_grn_greenskins
wh_main_anc_follower_greenskins_idol_carva	wh_main_sc_grn_savage_orcs
wh_main_anc_follower_greenskins_pit_boss	wh_main_sc_grn_greenskins
wh_main_anc_follower_greenskins_pit_boss	wh_main_sc_grn_savage_orcs
wh_main_anc_follower_greenskins_savage_orc_prodda	wh_main_sc_grn_greenskins
wh_main_anc_follower_greenskins_savage_orc_prodda	wh_main_sc_grn_savage_orcs
wh_main_anc_follower_greenskins_serial_loota	wh_main_sc_grn_greenskins
wh_main_anc_follower_greenskins_serial_loota	wh_main_sc_grn_savage_orcs
wh_main_anc_follower_greenskins_shamans_lacky	wh_main_sc_grn_greenskins
wh_main_anc_follower_greenskins_shamans_lacky	wh_main_sc_grn_savage_orcs
wh_main_anc_follower_greenskins_shroom_gathera	wh_main_sc_grn_greenskins
wh_main_anc_follower_greenskins_shroom_gathera	wh_main_sc_grn_savage_orcs
wh_main_anc_follower_greenskins_snotling_scavengers	wh_main_sc_grn_greenskins
wh_main_anc_follower_greenskins_snotling_scavengers	wh_main_sc_grn_savage_orcs
wh_main_anc_follower_greenskins_spider-god_priest	wh_main_sc_grn_greenskins
wh_main_anc_follower_greenskins_spider-god_priest	wh_main_sc_grn_savage_orcs
wh_main_anc_follower_greenskins_squig_mascot	wh_main_sc_grn_greenskins
wh_main_anc_follower_greenskins_squig_mascot	wh_main_sc_grn_savage_orcs
wh_main_anc_follower_greenskins_swindla	wh_main_sc_grn_greenskins
wh_main_anc_follower_greenskins_swindla	wh_main_sc_grn_savage_orcs
wh_main_anc_follower_greenskins_troll_herder	wh_main_sc_grn_greenskins
wh_main_anc_follower_greenskins_troll_herder	wh_main_sc_grn_savage_orcs
wh_main_anc_follower_halfling_fieldwarden	wh_main_sc_emp_empire
wh_main_anc_follower_norsca_berserker	wh_main_sc_chs_chaos
wh_main_anc_follower_norsca_berserker	wh_main_sc_nor_norsca
wh_main_anc_follower_undead_black_cat	wh_main_sc_vmp_vampire_counts
wh_main_anc_follower_undead_carrion	wh_main_sc_vmp_vampire_counts
wh_main_anc_follower_undead_corpse_thief	wh_main_sc_vmp_vampire_counts
wh_main_anc_follower_undead_crone	wh_main_sc_vmp_vampire_counts
wh_main_anc_follower_undead_dreg	wh_main_sc_vmp_vampire_counts
wh_main_anc_follower_undead_flesh_golem	wh_main_sc_vmp_vampire_counts
wh_main_anc_follower_undead_grave_digger	wh_main_sc_vmp_vampire_counts
wh_main_anc_follower_undead_manservant	wh_main_sc_vmp_vampire_counts
wh_main_anc_follower_undead_mortal_informer	wh_main_sc_vmp_vampire_counts
wh_main_anc_follower_undead_poltergeist	wh_main_sc_vmp_vampire_counts
wh_main_anc_follower_undead_possessed_mirror	wh_main_sc_vmp_vampire_counts
wh_main_anc_follower_undead_treasurer	wh_main_sc_vmp_vampire_counts
wh_main_anc_follower_undead_warlock	wh_main_sc_vmp_vampire_counts
wh_main_anc_follower_undead_warp_stone_hunter	wh_main_sc_vmp_vampire_counts
wh_main_anc_magic_standard_banner_of_lost_holds	wh_main_sc_dwf_dwarfs
wh_main_anc_magic_standard_banner_of_rage	wh_dlc03_sc_bst_beastmen
wh_main_anc_magic_standard_banner_of_rage	wh_main_sc_chs_chaos
wh_main_anc_magic_standard_banner_of_the_barrows	wh_main_sc_vmp_vampire_counts
wh_main_anc_magic_standard_blasted_standard	wh_dlc03_sc_bst_beastmen
wh_main_anc_magic_standard_blasted_standard	wh_main_sc_chs_chaos
wh_main_anc_magic_standard_da_immortulz	wh_main_sc_grn_greenskins
wh_main_anc_magic_standard_griffon_banner	wh_main_sc_emp_empire
wh_main_anc_magic_standard_griffon_banner	wh_main_sc_ksl_kislev
wh_main_anc_magic_standard_griffon_banner	wh_main_sc_teb_teb
wh_main_anc_magic_standard_morks_war_banner	wh_main_sc_grn_greenskins
wh_main_anc_magic_standard_spider_banner	wh_main_sc_grn_greenskins
wh_main_anc_magic_standard_steel_standard	wh_main_sc_emp_empire
wh_main_anc_magic_standard_steel_standard	wh_main_sc_ksl_kislev
wh_main_anc_magic_standard_steel_standard	wh_main_sc_teb_teb
wh_main_anc_magic_standard_the_bad_moon_banner	wh_main_sc_grn_greenskins
wh_main_anc_magic_standard_the_screaming_banner	wh_main_sc_vmp_vampire_counts
wh_main_anc_mark_of_chaos_mark_of_khorne	wh_main_sc_chs_chaos
wh_main_anc_mark_of_chaos_mark_of_nurgle	wh_main_sc_chs_chaos
wh_main_anc_mark_of_chaos_mark_of_slaanesh	wh_main_sc_chs_chaos
wh_main_anc_mark_of_chaos_mark_of_tzeentch	wh_main_sc_chs_chaos
wh_main_anc_mount_brt_damsel_barded_warhorse	wh_main_sc_brt_bretonnia
wh_main_anc_mount_brt_damsel_warhorse	wh_main_sc_brt_bretonnia
wh_main_anc_mount_brt_general_barded_warhorse	wh_main_sc_brt_bretonnia
wh_main_anc_mount_brt_general_hippogryph	wh_main_sc_brt_bretonnia
wh_main_anc_mount_brt_general_royal_pegasus	wh_main_sc_brt_bretonnia
wh_main_anc_mount_brt_louen_beaquis	wh_main_sc_brt_bretonnia
wh_main_anc_mount_brt_paladin_barded_warhorse	wh_main_sc_brt_bretonnia
wh_main_anc_mount_brt_paladin_pegasus	wh_main_sc_brt_bretonnia
wh_main_anc_mount_chs_archaon_dorghar	wh_main_sc_chs_chaos
wh_main_anc_mount_chs_chaos_lord_barded_chaos_steed	wh_main_sc_chs_chaos
wh_main_anc_mount_chs_chaos_lord_chaos_steed	wh_main_sc_chs_chaos
wh_main_anc_mount_chs_chaos_sorcerer_death_barded_chaos_steed	wh_main_sc_chs_chaos
wh_main_anc_mount_chs_chaos_sorcerer_death_chaos_steed	wh_main_sc_chs_chaos
wh_main_anc_mount_chs_chaos_sorcerer_fire_barded_chaos_steed	wh_main_sc_chs_chaos
wh_main_anc_mount_chs_chaos_sorcerer_fire_chaos_steed	wh_main_sc_chs_chaos
wh_main_anc_mount_chs_chaos_sorcerer_metal_barded_chaos_steed	wh_main_sc_chs_chaos
wh_main_anc_mount_chs_chaos_sorcerer_metal_chaos_steed	wh_main_sc_chs_chaos
wh_main_anc_mount_chs_exalted_hero_barded_chaos_steed	wh_main_sc_chs_chaos
wh_main_anc_mount_chs_exalted_hero_chaos_steed	wh_main_sc_chs_chaos
wh_main_anc_mount_emp_balthasar_imperial_pegasus	wh_main_sc_emp_empire
wh_main_anc_mount_emp_bright_wizard_barded_warhorse	wh_main_sc_emp_empire
wh_main_anc_mount_emp_bright_wizard_warhorse	wh_main_sc_emp_empire
wh_main_anc_mount_emp_captain_barded_warhorse	wh_main_sc_emp_empire
wh_main_anc_mount_emp_captain_imperial_pegasus	wh_main_sc_emp_empire
wh_main_anc_mount_emp_captain_warhorse	wh_main_sc_emp_empire
wh_main_anc_mount_emp_celestial_wizard_barded_warhorse	wh_main_sc_emp_empire
wh_main_anc_mount_emp_celestial_wizard_warhorse	wh_main_sc_emp_empire
wh_main_anc_mount_emp_general_barded_warhorse	wh_main_sc_emp_empire
wh_main_anc_mount_emp_general_imperial_griffon	wh_main_sc_emp_empire
wh_main_anc_mount_emp_general_imperial_pegasus	wh_main_sc_emp_empire
wh_main_anc_mount_emp_general_warhorse	wh_main_sc_emp_empire
wh_main_anc_mount_emp_karl_franz_barded_warhorse	wh_main_sc_emp_empire
wh_main_anc_mount_emp_karl_franz_deathclaw	wh_main_sc_emp_empire
wh_main_anc_mount_emp_karl_franz_imperial_pegasus	wh_main_sc_emp_empire
wh_main_anc_mount_emp_karl_franz_warhorse	wh_main_sc_emp_empire
wh_main_anc_mount_emp_light_wizard_barded_warhorse	wh_main_sc_emp_empire
wh_main_anc_mount_emp_light_wizard_warhorse	wh_main_sc_emp_empire
wh_main_anc_mount_emp_warrior_priest_barded_warhorse	wh_main_sc_emp_empire
wh_main_anc_mount_emp_warrior_priest_warhorse	wh_main_sc_emp_empire
wh_main_anc_mount_grn_azhag_skullmuncha	wh_main_sc_grn_greenskins
wh_main_anc_mount_grn_goblin_big_boss_giant_spider	wh_main_sc_grn_greenskins
wh_main_anc_mount_grn_goblin_big_boss_giant_wolf	wh_main_sc_grn_greenskins
wh_main_anc_mount_grn_goblin_great_shaman_giant_wolf	wh_main_sc_grn_greenskins
wh_main_anc_mount_grn_orc_warboss_war_boar	wh_main_sc_grn_greenskins
wh_main_anc_mount_grn_orc_warboss_wyvern	wh_main_sc_grn_greenskins
wh_main_anc_mount_grn_wizard_orc_shaman_war_boar	wh_main_sc_grn_greenskins
wh_main_anc_mount_ksl_captain_barded_warhorse	wh_main_sc_ksl_kislev
wh_main_anc_mount_ksl_captain_warhorse	wh_main_sc_ksl_kislev
wh_main_anc_mount_ksl_celestial_wizard_warhorse	wh_main_sc_ksl_kislev
wh_main_anc_mount_ksl_general_barded_warhorse	wh_main_sc_ksl_kislev
wh_main_anc_mount_ksl_general_warhorse	wh_main_sc_ksl_kislev
wh_main_anc_mount_nor_chaos_sorcerer_warhorse	wh_main_sc_nor_norsca
wh_main_anc_mount_nor_marauder_chieftain_warhorse	wh_main_sc_nor_norsca
wh_main_anc_mount_teb_bright_wizard_warhorse	wh_main_sc_teb_teb
wh_main_anc_mount_teb_captain_barded_warhorse	wh_main_sc_teb_teb
wh_main_anc_mount_teb_captain_warhorse	wh_main_sc_teb_teb
wh_main_anc_mount_teb_general_barded_warhorse	wh_main_sc_teb_teb
wh_main_anc_mount_teb_general_warhorse	wh_main_sc_teb_teb
wh_main_anc_mount_vmp_mannfred_barded_nightmare	wh_main_sc_vmp_vampire_counts
wh_main_anc_mount_vmp_mannfred_hellsteed	wh_main_sc_vmp_vampire_counts
wh_main_anc_mount_vmp_mannfred_zombie_dragon	wh_main_sc_vmp_vampire_counts
wh_main_anc_mount_vmp_master_necromancer_barded_nightmare	wh_main_sc_vmp_vampire_counts
wh_main_anc_mount_vmp_master_necromancer_hellsteed	wh_main_sc_vmp_vampire_counts
wh_main_anc_mount_vmp_necromancer_nightmare	wh_main_sc_vmp_vampire_counts
wh_main_anc_mount_vmp_vampire_barded_nightmare	wh_main_sc_vmp_vampire_counts
wh_main_anc_mount_vmp_vampire_hellsteed	wh_main_sc_vmp_vampire_counts
wh_main_anc_mount_vmp_vampire_lord_barded_nightmare	wh_main_sc_vmp_vampire_counts
wh_main_anc_mount_vmp_vampire_lord_hellsteed	wh_main_sc_vmp_vampire_counts
wh_main_anc_mount_vmp_vampire_lord_zombie_dragon	wh_main_sc_vmp_vampire_counts
wh_main_anc_mount_vmp_wight_king_barded_skeletal_steed	wh_main_sc_vmp_vampire_counts
wh_main_anc_mount_vmp_wight_king_skeletal_steed	wh_main_sc_vmp_vampire_counts
wh_main_anc_rune_ancestor_rune	wh_main_sc_dwf_dwarfs
wh_main_anc_rune_master_rune_of_battle	wh_main_sc_dwf_dwarfs
wh_main_anc_rune_master_rune_of_courage	wh_main_sc_dwf_dwarfs
wh_main_anc_rune_master_rune_of_groth_one-eye	wh_main_sc_dwf_dwarfs
wh_main_anc_rune_master_rune_of_grungni	wh_main_sc_dwf_dwarfs
wh_main_anc_rune_master_rune_of_sanctuary	wh_main_sc_dwf_dwarfs
wh_main_anc_rune_master_rune_of_slowness	wh_main_sc_dwf_dwarfs
wh_main_anc_rune_master_rune_of_stoicism	wh_main_sc_dwf_dwarfs
wh_main_anc_rune_master_rune_of_stromni_redbeard	wh_main_sc_dwf_dwarfs
wh_main_anc_rune_master_rune_of_valaya	wh_main_sc_dwf_dwarfs
wh_main_anc_rune_rune_of_fury	wh_main_sc_dwf_dwarfs
wh_main_anc_rune_rune_of_might	wh_main_sc_dwf_dwarfs
wh_main_anc_rune_rune_of_parrying	wh_main_sc_dwf_dwarfs
wh_main_anc_rune_rune_of_striking	wh_main_sc_dwf_dwarfs
wh_main_anc_rune_strollaz_rune	wh_main_sc_dwf_dwarfs
wh_main_anc_talisman_amulet_of_sea_gold	wh_main_sc_emp_empire
wh_main_anc_talisman_dragon_cloak_of_fyrskar	wh_main_sc_dwf_dwarfs
wh_main_anc_talisman_seed_of_rebirth	wh_main_sc_brt_bretonnia
wh_main_anc_talisman_seed_of_rebirth	wh_main_sc_dwf_dwarfs
wh_main_anc_talisman_seed_of_rebirth	wh_main_sc_emp_empire
wh_main_anc_talisman_seed_of_rebirth	wh_main_sc_grn_greenskins
wh_main_anc_talisman_seed_of_rebirth	wh_main_sc_grn_savage_orcs
wh_main_anc_talisman_seed_of_rebirth	wh_main_sc_ksl_kislev
wh_main_anc_talisman_seed_of_rebirth	wh_main_sc_teb_teb
wh_main_anc_talisman_the_dragon_crown_of_karaz	wh_main_sc_dwf_dwarfs
wh_main_anc_talisman_the_eye_of_sheerian	wh_main_sc_chs_chaos
wh_main_anc_talisman_the_silver_seal	wh_main_sc_emp_empire
wh_main_anc_talisman_the_white_cloak_of_ulric	wh_main_sc_emp_empire
wh_main_anc_talisman_the_white_cloak_of_ulric	wh_main_sc_ksl_kislev
wh_main_anc_talisman_the_white_cloak_of_ulric	wh_main_sc_teb_teb
wh_main_anc_weapon_axe_of_dargo	wh_main_sc_dwf_dwarfs
wh_main_anc_weapon_bashas_axe_of_stunty_smashin	wh_main_sc_grn_greenskins
wh_main_anc_weapon_battleaxe_of_the_last_waaagh	wh_main_sc_grn_greenskins
wh_main_anc_weapon_chaos_tomb_blade	wh_main_sc_vmp_vampire_counts
wh_main_anc_weapon_filth_mace	wh_dlc03_sc_bst_beastmen
wh_main_anc_weapon_filth_mace	wh_main_sc_chs_chaos
wh_main_anc_weapon_ghal_maraz	wh_main_sc_emp_empire
wh_main_anc_weapon_gitsnik	wh_main_sc_grn_greenskins
wh_main_anc_weapon_hellfire_sword	wh_dlc03_sc_bst_beastmen
wh_main_anc_weapon_hellfire_sword	wh_main_sc_chs_chaos
wh_main_anc_weapon_red_axe_of_karak_eight_peaks	wh_main_sc_dwf_dwarfs
wh_main_anc_weapon_runefang	wh_main_sc_emp_empire
wh_main_anc_weapon_skabscrath	wh_main_sc_vmp_vampire_counts
wh_main_anc_weapon_slaggas_slashas	wh_main_sc_grn_greenskins
wh_main_anc_weapon_sliverslash	wh_main_sc_chs_chaos
wh_main_anc_weapon_starcrusher	wh_main_sc_chs_chaos
wh_main_anc_weapon_stave_of_ruinous_corruption	wh_dlc03_sc_bst_beastmen
wh_main_anc_weapon_sword_of_unholy_power	wh_main_sc_vmp_vampire_counts
wh_main_anc_weapon_the_axe_of_grimnir	wh_main_sc_dwf_dwarfs
wh_main_anc_weapon_the_hammer_of_karak_drazh	wh_main_sc_dwf_dwarfs
wh_main_anc_weapon_the_mace_of_helsturm	wh_main_sc_emp_empire
wh_main_anc_weapon_the_mace_of_helsturm	wh_main_sc_ksl_kislev
wh_main_anc_weapon_the_mace_of_helsturm	wh_main_sc_teb_teb
wh_main_anc_weapon_the_middenland_runefang	wh_main_sc_emp_empire
wh_main_anc_weapon_the_reikland_runefang	wh_main_sc_emp_empire
wh_main_anc_weapon_the_slayer_of_kings	wh_main_sc_chs_chaos
wh_main_anc_weapon_the_sword_of_couronne	wh_main_sc_brt_bretonnia
wh_pro01_anc_armour_armour_of_glimril_scales	wh_main_sc_dwf_dwarfs
wh_pro01_anc_enchanted_item_rune_helm_of_zhufbar	wh_main_sc_dwf_dwarfs
wh_pro01_anc_rune_rune_of_fury	wh_main_sc_dwf_dwarfs
wh_pro01_anc_rune_rune_of_might	wh_main_sc_dwf_dwarfs
wh_pro01_anc_rune_rune_of_parrying	wh_main_sc_dwf_dwarfs
wh_pro01_anc_rune_rune_of_striking	wh_main_sc_dwf_dwarfs
wh_pro01_anc_talisman_cloak_of_valaya	wh_main_sc_dwf_dwarfs
wh_pro01_anc_weapon_the_rune_axe_of_grombrindal	wh_main_sc_dwf_dwarfs
wh_pro02_anc_enchanted_item_blood_chalice_of_bathori	wh_main_sc_vmp_vampire_counts
wh_pro02_anc_mount_vmp_isabella_barded_nightmare	wh_main_sc_vmp_vampire_counts
wh_pro02_anc_mount_vmp_isabella_hellsteed	wh_main_sc_vmp_vampire_counts
