climbing_ladders_meshes_definitions_tables
0
unknown0	unknown1
att_fact_blue	wh_main_glb_siege_ladder_01
att_fact_red	wh_main_glb_siege_ladder_01
att_fact_yellow	wh_main_glb_siege_ladder_01
wh2_main_brt_knights_of_origo	wh_main_brt_siege_ladder
wh2_main_brt_knights_of_the_flame	wh_main_brt_siege_ladder
wh2_main_brt_thegans_crusaders	wh_main_brt_siege_ladder
wh2_main_bst_blooded_axe	wh_main_glb_siege_ladder_02
wh2_main_bst_blooded_axe_brayherd	wh_main_glb_siege_ladder_02
wh2_main_bst_manblight	wh_main_glb_siege_ladder_02
wh2_main_bst_manblight_brayherd	wh_main_glb_siege_ladder_02
wh2_main_bst_ripper_horn	wh_main_glb_siege_ladder_02
wh2_main_bst_ripper_horn_brayherd	wh_main_glb_siege_ladder_02
wh2_main_bst_shadowgor	wh_main_glb_siege_ladder_02
wh2_main_bst_shadowgor_brayherd	wh_main_glb_siege_ladder_02
wh2_main_bst_skrinderkin	wh_main_glb_siege_ladder_02
wh2_main_bst_skrinderkin_brayherd	wh_main_glb_siege_ladder_02
wh2_main_bst_stone_horn	wh_main_glb_siege_ladder_02
wh2_main_bst_stone_horn_brayherd	wh_main_glb_siege_ladder_02
wh2_main_chs_chaos_incursion_def	wh_main_glb_siege_ladder_02
wh2_main_chs_chaos_incursion_hef	wh_main_glb_siege_ladder_02
wh2_main_chs_chaos_incursion_lzd	wh_main_glb_siege_ladder_02
wh2_main_chs_chaos_incursion_skv	wh_main_glb_siege_ladder_02
wh2_main_def_bleak_holds	wh2_main_def_siege_ladder_01
wh2_main_def_blood_hall_coven	wh2_main_def_siege_ladder_01
wh2_main_def_clar_karond	wh2_main_def_siege_ladder_01
wh2_main_def_cult_of_excess	wh2_main_def_siege_ladder_01
wh2_main_def_cult_of_pleasure	wh2_main_def_siege_ladder_01
wh2_main_def_cult_of_pleasure_separatists	wh2_main_def_siege_ladder_01
wh2_main_def_dark_elves	wh2_main_def_siege_ladder_01
wh2_main_def_dark_elves_intervention	wh2_main_def_siege_ladder_01
wh2_main_def_dark_elves_qb1	wh2_main_def_siege_ladder_01
wh2_main_def_dark_elves_qb2	wh2_main_def_siege_ladder_01
wh2_main_def_dark_elves_qb3	wh2_main_def_siege_ladder_01
wh2_main_def_dark_elves_qb4	wh2_main_def_siege_ladder_01
wh2_main_def_dark_elves_rebels	wh2_main_def_siege_ladder_01
wh2_main_def_deadwood_sentinels	wh2_main_def_siege_ladder_01
wh2_main_def_drackla_coven	wh2_main_def_siege_ladder_01
wh2_main_def_ghrond	wh2_main_def_siege_ladder_01
wh2_main_def_hag_graef	wh2_main_def_siege_ladder_01
wh2_main_def_har_ganeth	wh2_main_def_siege_ladder_01
wh2_main_def_karond_kar	wh2_main_def_siege_ladder_01
wh2_main_def_naggarond	wh2_main_def_siege_ladder_01
wh2_main_def_naggarond_separatists	wh2_main_def_siege_ladder_01
wh2_main_def_scourge_of_khaine	wh2_main_def_siege_ladder_01
wh2_main_def_ssildra_tor	wh2_main_def_siege_ladder_01
wh2_main_def_the_forgebound	wh2_main_def_siege_ladder_01
wh2_main_dwf_greybeards_prospectors	wh_main_glb_siege_ladder_02
wh2_main_dwf_karak_zorn	wh_main_glb_siege_ladder_02
wh2_main_dwf_spine_of_sotek_dwarfs	wh_main_glb_siege_ladder_01
wh2_main_emp_new_world_colonies	wh_main_emp_siege_ladder
wh2_main_emp_pirates_of_sartosa	wh_main_emp_siege_ladder
wh2_main_emp_sudenburg	wh_main_emp_siege_ladder
wh2_main_grn_arachnos	wh_main_glb_siege_ladder_02
wh2_main_grn_arachnos_waaagh	wh_main_glb_siege_ladder_02
wh2_main_grn_blue_vipers	wh_main_glb_siege_ladder_02
wh2_main_grn_blue_vipers_waaagh	wh_main_glb_siege_ladder_02
wh2_main_hef_avelorn	wh2_main_hef_siege_ladder_01
wh2_main_hef_caledor	wh2_main_hef_siege_ladder_01
wh2_main_hef_chrace	wh2_main_hef_siege_ladder_01
wh2_main_hef_citadel_of_dusk	wh2_main_hef_siege_ladder_01
wh2_main_hef_cothique	wh2_main_hef_siege_ladder_01
wh2_main_hef_eataine	wh2_main_hef_siege_ladder_01
wh2_main_hef_ellyrion	wh2_main_hef_siege_ladder_01
wh2_main_hef_fortress_of_dawn	wh2_main_hef_siege_ladder_01
wh2_main_hef_high_elves	wh2_main_hef_siege_ladder_01
wh2_main_hef_high_elves_intervention	wh2_main_hef_siege_ladder_01
wh2_main_hef_high_elves_qb1	wh2_main_hef_siege_ladder_01
wh2_main_hef_high_elves_qb2	wh2_main_hef_siege_ladder_01
wh2_main_hef_high_elves_qb3	wh2_main_hef_siege_ladder_01
wh2_main_hef_high_elves_qb4	wh2_main_hef_siege_ladder_01
wh2_main_hef_high_elves_rebels	wh2_main_hef_siege_ladder_01
wh2_main_hef_nagarythe	wh2_main_hef_siege_ladder_01
wh2_main_hef_order_of_loremasters	wh2_main_hef_siege_ladder_01
wh2_main_hef_saphery	wh2_main_hef_siege_ladder_01
wh2_main_hef_tiranoc	wh2_main_hef_siege_ladder_01
wh2_main_hef_tor_elasor	wh2_main_hef_siege_ladder_01
wh2_main_hef_yvresse	wh2_main_hef_siege_ladder_01
wh2_main_lzd_hexoatl	wh2_main_lzd_siege_ladder_01
wh2_main_lzd_itza	wh2_main_lzd_siege_ladder_01
wh2_main_lzd_last_defenders	wh2_main_lzd_siege_ladder_01
wh2_main_lzd_lizardmen	wh2_main_lzd_siege_ladder_01
wh2_main_lzd_lizardmen_intervention	wh2_main_lzd_siege_ladder_01
wh2_main_lzd_lizardmen_qb1	wh2_main_lzd_siege_ladder_01
wh2_main_lzd_lizardmen_qb2	wh2_main_lzd_siege_ladder_01
wh2_main_lzd_lizardmen_qb3	wh2_main_lzd_siege_ladder_01
wh2_main_lzd_lizardmen_qb4	wh2_main_lzd_siege_ladder_01
wh2_main_lzd_lizardmen_rebels	wh2_main_lzd_siege_ladder_01
wh2_main_lzd_sentinels_of_xeti	wh2_main_lzd_siege_ladder_01
wh2_main_lzd_southern_sentinels	wh2_main_lzd_siege_ladder_01
wh2_main_lzd_teotiqua	wh2_main_lzd_siege_ladder_01
wh2_main_lzd_tlaqua	wh2_main_lzd_siege_ladder_01
wh2_main_lzd_tlaxtlan	wh2_main_lzd_siege_ladder_01
wh2_main_lzd_xlanhuapec	wh2_main_lzd_siege_ladder_01
wh2_main_lzd_zlatan	wh2_main_lzd_siege_ladder_01
wh2_main_nor_aghol	wh_main_glb_siege_ladder_02
wh2_main_nor_hung_incursion_def	wh_main_glb_siege_ladder_02
wh2_main_nor_hung_incursion_hef	wh_main_glb_siege_ladder_02
wh2_main_nor_hung_incursion_lzd	wh_main_glb_siege_ladder_02
wh2_main_nor_hung_incursion_skv	wh_main_glb_siege_ladder_02
wh2_main_nor_mung	wh_main_glb_siege_ladder_02
wh2_main_nor_skeggi	wh_main_glb_siege_ladder_02
wh2_main_rogue_abominations	wh_main_glb_siege_ladder_01
wh2_main_rogue_beastcatchas	wh_main_glb_siege_ladder_01
wh2_main_rogue_bernhoffs_brigands	wh_main_glb_siege_ladder_01
wh2_main_rogue_black_spider_tribe	wh_main_glb_siege_ladder_01
wh2_main_rogue_boneclubbers_tribe	wh_main_glb_siege_ladder_01
wh2_main_rogue_celestial_storm	wh_main_glb_siege_ladder_01
wh2_main_rogue_college_of_pyrotechnics	wh_main_glb_siege_ladder_01
wh2_main_rogue_def_chs_vashnaar	wh_main_glb_siege_ladder_01
wh2_main_rogue_def_mengils_manflayers	wh_main_glb_siege_ladder_01
wh2_main_rogue_doomseekers	wh_main_glb_siege_ladder_01
wh2_main_rogue_gerhardts_mercenaries	wh_main_glb_siege_ladder_01
wh2_main_rogue_hef_tor_elithis	wh_main_glb_siege_ladder_01
wh2_main_rogue_hung_warband	wh_main_glb_siege_ladder_01
wh2_main_rogue_jerrods_errantry	wh_main_glb_siege_ladder_01
wh2_main_rogue_mangy_houndz	wh_main_glb_siege_ladder_01
wh2_main_rogue_morrsliebs_howlers	wh_main_glb_siege_ladder_01
wh2_main_rogue_pirates_of_the_far_sea	wh_main_glb_siege_ladder_01
wh2_main_rogue_pirates_of_the_southern_ocean	wh_main_glb_siege_ladder_01
wh2_main_rogue_pirates_of_trantio	wh_main_glb_siege_ladder_01
wh2_main_rogue_scions_of_tesseninck	wh_main_glb_siege_ladder_01
wh2_main_rogue_scourge_of_aquitaine	wh_main_glb_siege_ladder_01
wh2_main_rogue_stuff_snatchers	wh_main_glb_siege_ladder_01
wh2_main_rogue_teef_snatchaz	wh_main_glb_siege_ladder_01
wh2_main_rogue_the_wandering_dead	wh_main_glb_siege_ladder_01
wh2_main_rogue_troll_skullz	wh_main_glb_siege_ladder_01
wh2_main_rogue_vauls_expedition	wh_main_glb_siege_ladder_01
wh2_main_rogue_vmp_heirs_of_mourkain	wh_main_glb_siege_ladder_01
wh2_main_rogue_wef_hunters_of_kurnous	wh_main_glb_siege_ladder_01
wh2_main_rogue_worldroot_rangers	wh_main_glb_siege_ladder_01
wh2_main_rogue_wrath_of_nature	wh_main_glb_siege_ladder_01
wh2_main_skv_clan_eshin	wh2_main_skv_siege_ladder_01
wh2_main_skv_clan_gnaw	wh2_main_skv_siege_ladder_01
wh2_main_skv_clan_mordkin	wh2_main_skv_siege_ladder_01
wh2_main_skv_clan_mors	wh2_main_skv_siege_ladder_01
wh2_main_skv_clan_mors_separatists	wh2_main_skv_siege_ladder_01
wh2_main_skv_clan_moulder	wh2_main_skv_siege_ladder_01
wh2_main_skv_clan_pestilens	wh2_main_skv_siege_ladder_01
wh2_main_skv_clan_pestilens_separatists	wh2_main_skv_siege_ladder_01
wh2_main_skv_clan_septik	wh2_main_skv_siege_ladder_01
wh2_main_skv_clan_skyre	wh2_main_skv_siege_ladder_01
wh2_main_skv_clan_spittel	wh2_main_skv_siege_ladder_01
wh2_main_skv_grey_seer_clan	wh2_main_skv_siege_ladder_01
wh2_main_skv_skaven	wh2_main_skv_siege_ladder_01
wh2_main_skv_skaven_intervention	wh2_main_skv_siege_ladder_01
wh2_main_skv_skaven_qb1	wh2_main_skv_siege_ladder_01
wh2_main_skv_skaven_qb2	wh2_main_skv_siege_ladder_01
wh2_main_skv_skaven_qb3	wh2_main_skv_siege_ladder_01
wh2_main_skv_skaven_qb4	wh2_main_skv_siege_ladder_01
wh2_main_skv_skaven_rebels	wh2_main_skv_siege_ladder_01
wh2_main_skv_unknown_clan_def	wh2_main_skv_siege_ladder_01
wh2_main_skv_unknown_clan_hef	wh2_main_skv_siege_ladder_01
wh2_main_skv_unknown_clan_lzd	wh2_main_skv_siege_ladder_01
wh2_main_skv_unknown_clan_skv	wh2_main_skv_siege_ladder_01
wh2_main_vmp_necrarch_brotherhood	wh_main_glb_siege_ladder_02
wh2_main_vmp_strygos_empire	wh_main_glb_siege_ladder_02
wh2_main_vmp_the_silver_host	wh_main_glb_siege_ladder_02
wh2_main_vmp_vampire_coast	wh_main_glb_siege_ladder_01
wh2_main_wef_bowmen_of_oreon	wh_main_glb_siege_ladder_02
wh_dlc03_bst_beastmen	wh_main_glb_siege_ladder_02
wh_dlc03_bst_beastmen_brayherd	wh_main_glb_siege_ladder_02
wh_dlc03_bst_beastmen_chaos	wh_main_glb_siege_ladder_02
wh_dlc03_bst_beastmen_chaos_brayherd	wh_main_glb_siege_ladder_02
wh_dlc03_bst_beastmen_qb1	wh_main_glb_siege_ladder_02
wh_dlc03_bst_beastmen_qb2	wh_main_glb_siege_ladder_02
wh_dlc03_bst_beastmen_qb3	wh_main_glb_siege_ladder_02
wh_dlc03_bst_beastmen_rebels	wh_main_glb_siege_ladder_02
wh_dlc03_bst_jagged_horn	wh_main_glb_siege_ladder_02
wh_dlc03_bst_jagged_horn_brayherd	wh_main_glb_siege_ladder_02
wh_dlc03_bst_mini_beastmen_rebels	wh_main_glb_siege_ladder_02
wh_dlc03_bst_mini_beastmen_rebels_brayherd	wh_main_glb_siege_ladder_02
wh_dlc03_bst_mini_jagged_horn	wh_main_glb_siege_ladder_02
wh_dlc03_bst_mini_jagged_horn_brayherd	wh_main_glb_siege_ladder_02
wh_dlc03_bst_mini_khazrak_herd	wh_main_glb_siege_ladder_02
wh_dlc03_bst_mini_khazrak_herd_brayherd	wh_main_glb_siege_ladder_02
wh_dlc03_bst_mini_redhorn	wh_main_glb_siege_ladder_02
wh_dlc03_bst_mini_redhorn_brayherd	wh_main_glb_siege_ladder_02
wh_dlc03_bst_mini_ripper_horn	wh_main_glb_siege_ladder_02
wh_dlc03_bst_mini_ripper_horn_brayherd	wh_main_glb_siege_ladder_02
wh_dlc03_bst_mini_shadowgor	wh_main_glb_siege_ladder_02
wh_dlc03_bst_mini_shadowgor_brayherd	wh_main_glb_siege_ladder_02
wh_dlc03_bst_mini_skrinderkin	wh_main_glb_siege_ladder_02
wh_dlc03_bst_mini_skrinderkin_brayherd	wh_main_glb_siege_ladder_02
wh_dlc03_bst_redhorn	wh_main_glb_siege_ladder_02
wh_dlc03_bst_redhorn_brayherd	wh_main_glb_siege_ladder_02
wh_dlc03_emp_carroburg	wh_main_emp_siege_ladder
wh_dlc03_emp_cult_of_ulric	wh_main_emp_siege_ladder
wh_dlc03_emp_empire_qb1	wh_main_emp_siege_ladder
wh_dlc03_emp_empire_qb2	wh_main_emp_siege_ladder
wh_dlc03_emp_empire_qb3	wh_main_emp_siege_ladder
wh_dlc03_emp_empire_qb4	wh_main_emp_siege_ladder
wh_dlc03_emp_empire_rebels	wh_main_emp_siege_ladder
wh_dlc03_emp_hochland	wh_main_emp_siege_ladder
wh_dlc03_emp_marienburg	wh_main_emp_siege_ladder
wh_dlc03_emp_marienburg_rebels	wh_main_emp_siege_ladder
wh_dlc03_emp_middenland	wh_main_emp_siege_ladder
wh_dlc03_grn_black_pit	wh_main_glb_siege_ladder_02
wh_dlc03_grn_black_pit_waaagh	wh_main_glb_siege_ladder_02
wh_dlc03_grn_gloomy_woods	wh_main_glb_siege_ladder_02
wh_dlc03_grn_gloomy_woods_waaagh	wh_main_glb_siege_ladder_02
wh_dlc03_grn_greenskin_rebels	wh_main_glb_siege_ladder_02
wh_dlc03_grn_greenskin_rebels_waaagh	wh_main_glb_siege_ladder_02
wh_dlc05_brt_mini_aquitaine	wh_main_brt_siege_ladder
wh_dlc05_brt_mini_bastonne	wh_main_brt_siege_ladder
wh_dlc05_brt_mini_bordeleaux	wh_main_brt_siege_ladder
wh_dlc05_brt_mini_bretonnia_rebels	wh_main_brt_siege_ladder
wh_dlc05_brt_mini_brionne	wh_main_brt_siege_ladder
wh_dlc05_brt_mini_carcassonne	wh_main_brt_siege_ladder
wh_dlc05_brt_mini_gisoreux	wh_main_brt_siege_ladder
wh_dlc05_brt_mini_montfort	wh_main_brt_siege_ladder
wh_dlc05_brt_mini_parravon	wh_main_brt_siege_ladder
wh_dlc05_brt_mini_quenelles	wh_main_brt_siege_ladder
wh_dlc05_bst_mini_beastmen_rebels	wh_main_glb_siege_ladder_02
wh_dlc05_bst_mini_beastmen_rebels_brayherd	wh_main_glb_siege_ladder_01
wh_dlc05_bst_mini_morghur_herd	wh_main_glb_siege_ladder_02
wh_dlc05_bst_mini_morghur_herd_brayherd	wh_main_glb_siege_ladder_02
wh_dlc05_grn_mini_deff_grindaz	wh_main_glb_siege_ladder_02
wh_dlc05_grn_mini_deff_grindaz_waaagh	wh_main_glb_siege_ladder_02
wh_dlc05_grn_mini_greenskin_rebels	wh_main_glb_siege_ladder_02
wh_dlc05_grn_mini_greenskin_rebels_waaagh	wh_main_glb_siege_ladder_02
wh_dlc05_grn_mini_skullsmasherz	wh_main_glb_siege_ladder_02
wh_dlc05_grn_mini_skullsmasherz_waaagh	wh_main_glb_siege_ladder_02
wh_dlc05_vmp_mousillon	wh_main_glb_siege_ladder_01
wh_dlc05_wef_argwylon	wh_main_glb_siege_ladder_01
wh_dlc05_wef_mini_anmyr	wh_main_glb_siege_ladder_01
wh_dlc05_wef_mini_argwylon	wh_main_glb_siege_ladder_01
wh_dlc05_wef_mini_arranoc	wh_main_glb_siege_ladder_01
wh_dlc05_wef_mini_atylwyth	wh_main_glb_siege_ladder_01
wh_dlc05_wef_mini_cavaroc	wh_main_glb_siege_ladder_01
wh_dlc05_wef_mini_cythral	wh_main_glb_siege_ladder_01
wh_dlc05_wef_mini_fyr_darric	wh_main_glb_siege_ladder_01
wh_dlc05_wef_mini_modryn	wh_main_glb_siege_ladder_01
wh_dlc05_wef_mini_tirsyth	wh_main_glb_siege_ladder_01
wh_dlc05_wef_mini_torgovann	wh_main_glb_siege_ladder_01
wh_dlc05_wef_mini_wood_elves	wh_main_glb_siege_ladder_01
wh_dlc05_wef_mini_wydrioth	wh_main_glb_siege_ladder_01
wh_dlc05_wef_torgovann	wh_main_glb_siege_ladder_01
wh_dlc05_wef_wood_elves	wh_main_glb_siege_ladder_01
wh_dlc05_wef_wood_elves_rebels	wh_main_glb_siege_ladder_01
wh_dlc05_wef_wydrioth	wh_main_glb_siege_ladder_01
wh_main_brt_artois	wh_main_brt_siege_ladder
wh_main_brt_bastonne	wh_main_brt_siege_ladder
wh_main_brt_bordeleaux	wh_main_brt_siege_ladder
wh_main_brt_bretonnia	wh_main_brt_siege_ladder
wh_main_brt_bretonnia_qb1	wh_main_brt_siege_ladder
wh_main_brt_bretonnia_qb2	wh_main_brt_siege_ladder
wh_main_brt_bretonnia_qb3	wh_main_brt_siege_ladder
wh_main_brt_bretonnia_rebels	wh_main_brt_siege_ladder
wh_main_brt_carcassonne	wh_main_brt_siege_ladder
wh_main_brt_lyonesse	wh_main_brt_siege_ladder
wh_main_brt_parravon	wh_main_brt_siege_ladder
wh_main_chs_chaos	wh_main_glb_siege_ladder_02
wh_main_chs_chaos_qb1	wh_main_glb_siege_ladder_02
wh_main_chs_chaos_qb2	wh_main_glb_siege_ladder_02
wh_main_chs_chaos_qb3	wh_main_glb_siege_ladder_02
wh_main_chs_chaos_rebels	wh_main_glb_siege_ladder_02
wh_main_chs_chaos_separatists	wh_main_glb_siege_ladder_02
wh_main_dwf_barak_varr	wh_main_glb_siege_ladder_01
wh_main_dwf_dwarf_rebels	wh_main_glb_siege_ladder_01
wh_main_dwf_dwarfs	wh_main_glb_siege_ladder_01
wh_main_dwf_dwarfs_qb1	wh_main_glb_siege_ladder_01
wh_main_dwf_dwarfs_qb2	wh_main_glb_siege_ladder_01
wh_main_dwf_dwarfs_qb3	wh_main_glb_siege_ladder_01
wh_main_dwf_dwarfs_qb4	wh_main_glb_siege_ladder_01
wh_main_dwf_dwarfs_seperatists_qb1	wh_main_glb_siege_ladder_01
wh_main_dwf_dwarfs_seperatists_qb2	wh_main_glb_siege_ladder_01
wh_main_dwf_dwarfs_seperatists_qb3	wh_main_glb_siege_ladder_01
wh_main_dwf_dwarfs_seperatists_qb4	wh_main_glb_siege_ladder_01
wh_main_dwf_karak_azul	wh_main_glb_siege_ladder_01
wh_main_dwf_karak_hirn	wh_main_glb_siege_ladder_01
wh_main_dwf_karak_izor	wh_main_glb_siege_ladder_01
wh_main_dwf_karak_kadrin	wh_main_glb_siege_ladder_01
wh_main_dwf_karak_norn	wh_main_glb_siege_ladder_01
wh_main_dwf_karak_ziflin	wh_main_glb_siege_ladder_01
wh_main_dwf_kraka_drak	wh_main_glb_siege_ladder_01
wh_main_dwf_zhufbar	wh_main_glb_siege_ladder_01
wh_main_emp_averland	wh_main_emp_siege_ladder
wh_main_emp_empire	wh_main_emp_siege_ladder
wh_main_emp_empire_qb1	wh_main_emp_siege_ladder
wh_main_emp_empire_qb2	wh_main_emp_siege_ladder
wh_main_emp_empire_qb3	wh_main_emp_siege_ladder
wh_main_emp_empire_qb4	wh_main_emp_siege_ladder
wh_main_emp_empire_rebels	wh_main_emp_siege_ladder
wh_main_emp_empire_rebels_qb1	wh_main_emp_siege_ladder
wh_main_emp_empire_separatists	wh_main_emp_siege_ladder
wh_main_emp_hochland	wh_main_emp_siege_ladder
wh_main_emp_marienburg	wh_main_emp_siege_ladder
wh_main_emp_marienburg_rebels	wh_main_emp_siege_ladder
wh_main_emp_middenland	wh_main_emp_siege_ladder
wh_main_emp_nordland	wh_main_emp_siege_ladder
wh_main_emp_ostermark	wh_main_emp_siege_ladder
wh_main_emp_ostland	wh_main_emp_siege_ladder
wh_main_emp_stirland	wh_main_emp_siege_ladder
wh_main_emp_talabecland	wh_main_emp_siege_ladder
wh_main_emp_wissenland	wh_main_emp_siege_ladder
wh_main_grn_black_venom	wh_main_glb_siege_ladder_02
wh_main_grn_black_venom_waaagh	wh_main_glb_siege_ladder_02
wh_main_grn_bloody_spearz	wh_main_glb_siege_ladder_02
wh_main_grn_bloody_spearz_waaagh	wh_main_glb_siege_ladder_02
wh_main_grn_broken_nose	wh_main_glb_siege_ladder_02
wh_main_grn_broken_nose_waaagh	wh_main_glb_siege_ladder_02
wh_main_grn_crooked_moon	wh_main_glb_siege_ladder_02
wh_main_grn_crooked_moon_waaagh	wh_main_glb_siege_ladder_02
wh_main_grn_greenskins	wh_main_glb_siege_ladder_02
wh_main_grn_greenskins_qb1	wh_main_glb_siege_ladder_02
wh_main_grn_greenskins_qb2	wh_main_glb_siege_ladder_02
wh_main_grn_greenskins_qb3	wh_main_glb_siege_ladder_02
wh_main_grn_greenskins_qb4	wh_main_glb_siege_ladder_02
wh_main_grn_greenskins_rebels	wh_main_glb_siege_ladder_02
wh_main_grn_greenskins_rebels_waaagh	wh_main_glb_siege_ladder_02
wh_main_grn_greenskins_waaagh	wh_main_glb_siege_ladder_02
wh_main_grn_necksnappers	wh_main_glb_siege_ladder_02
wh_main_grn_necksnappers_waaagh	wh_main_glb_siege_ladder_02
wh_main_grn_orcs_of_the_bloody_hand	wh_main_glb_siege_ladder_02
wh_main_grn_orcs_of_the_bloody_hand_waaagh	wh_main_glb_siege_ladder_02
wh_main_grn_red_eye	wh_main_glb_siege_ladder_02
wh_main_grn_red_eye_waaagh	wh_main_glb_siege_ladder_02
wh_main_grn_red_fangs	wh_main_glb_siege_ladder_02
wh_main_grn_red_fangs_waaagh	wh_main_glb_siege_ladder_02
wh_main_grn_scabby_eye	wh_main_glb_siege_ladder_02
wh_main_grn_scabby_eye_waaagh	wh_main_glb_siege_ladder_02
wh_main_grn_skull-takerz	wh_main_glb_siege_ladder_02
wh_main_grn_skull-takerz_waaagh	wh_main_glb_siege_ladder_02
wh_main_grn_skullsmasherz	wh_main_glb_siege_ladder_02
wh_main_grn_skullsmasherz_waaagh	wh_main_glb_siege_ladder_02
wh_main_grn_teef_snatchaz	wh_main_glb_siege_ladder_02
wh_main_grn_teef_snatchaz_waaagh	wh_main_glb_siege_ladder_02
wh_main_grn_top_knotz	wh_main_glb_siege_ladder_02
wh_main_grn_top_knotz_waaagh	wh_main_glb_siege_ladder_02
wh_main_ksl_kislev	wh_main_emp_siege_ladder
wh_main_ksl_kislev_rebels	wh_main_emp_siege_ladder
wh_main_nor_aesling	wh_main_glb_siege_ladder_02
wh_main_nor_baersonling	wh_main_glb_siege_ladder_02
wh_main_nor_bjornling	wh_main_glb_siege_ladder_02
wh_main_nor_graeling	wh_main_glb_siege_ladder_02
wh_main_nor_norsca_qb1	wh_main_glb_siege_ladder_02
wh_main_nor_norsca_qb2	wh_main_glb_siege_ladder_02
wh_main_nor_norsca_qb3	wh_main_glb_siege_ladder_02
wh_main_nor_norsca_rebels	wh_main_glb_siege_ladder_02
wh_main_nor_sarl	wh_main_glb_siege_ladder_02
wh_main_nor_skaeling	wh_main_glb_siege_ladder_02
wh_main_nor_varg	wh_main_glb_siege_ladder_02
wh_main_teb_border_princes	wh_main_emp_siege_ladder
wh_main_teb_border_princes_rebels	wh_main_emp_siege_ladder
wh_main_teb_estalia	wh_main_emp_siege_ladder
wh_main_teb_estalia_rebels	wh_main_emp_siege_ladder
wh_main_teb_tilea	wh_main_emp_siege_ladder
wh_main_teb_tilea_rebels	wh_main_emp_siege_ladder
wh_main_vmp_mousillon	wh_main_glb_siege_ladder_01
wh_main_vmp_rival_sylvanian_vamps	wh_main_glb_siege_ladder_01
wh_main_vmp_schwartzhafen	wh_main_glb_siege_ladder_01
wh_main_vmp_vampire_counts	wh_main_glb_siege_ladder_01
wh_main_vmp_vampire_counts_qb1	wh_main_glb_siege_ladder_01
wh_main_vmp_vampire_counts_qb2	wh_main_glb_siege_ladder_01
wh_main_vmp_vampire_counts_qb3	wh_main_glb_siege_ladder_01
wh_main_vmp_vampire_rebels	wh_main_glb_siege_ladder_01
wh_main_vmp_waldenhof	wh_main_glb_siege_ladder_01
